अँगड़ाई	yawn  
अन्ग्रेजी	English  
अँग्स्ट्रॉम	angstrom  
अँडरसन	anderson  
अँथनी	anthony  
अँथोनी	anthony  
अंक	number  
अंकगणित	numerical
अंकगनित	numerical
अंकित	dedicated  
अंकिता	ankita  
अंकुर	sprout  
अंकुश	ankush  
अंकों	Numbers  
अंग	Body part  
अंगडाई	yawn  
अंगद	angad  
अंगरकशक	body guard  
अंगरक्षक	body guard  
अंगरॆजि	english  
अंगरॆजॊं	english people  
अंगरेजी	English  
अंगों	Parts  
अंग्रेज़ी	english  
अंग्रेजी	english  
अंग्रेजों	British  
अंग्रेज़ी	english  
अंचल	anchal  
अंजन	anjan  
अंजना	anjana  
अंजाम	Consequence  
अंजु	anju  
अंजुम	anjum  
अंजुमन	anjuman
अंजू	Anju  
अंटारकटिक	antartic  
अंटार्कटिका	antartica  
अंटार्क्टिका	antartica  
अंडमान	Andaman  
अंडर	Under  
अंडरवरलड	Under world  
अंडरवर्ल्ड	Under world  
अंडरवल्र्ड	Under world  
अंडरस	unders  
अंडरसन	anderson
अंडा	egg
अंडे	Eggs  
अंडों	Eggs  
अंत	End  
अंततः	Everywhere
अंततऱ् 	difference
अंतर	Difference  
अंतरदृशटि	sixth sense  
अंतरराजयिय	inter state  
अंतरराशटरिय	international  
अंतरराष्ट	International  
अंतरराष्ट्र	International  
अंतरराष्ट्रीय	International  
अंतरा	Antara  
अंतराल	interval  
अंतराळ	interval  
अंतराशटरिय	International  
अंतराष्ट्रीय	International  
अंतरिकश	space  
अंतरिक्ष	Space  
अंतरिम	Interim  
अंतरीक्ष	space  
अंतर्ध्वनि	 inside voice
अंतर्मुख	inside voice
अंतर्राष्ट्रीय	International  
अंदर	Inside  
अंदरुनि	internal  
अंदाज	Style  
अंदाजः	Style  
अंदाज़	Style  
अंदाज़	Style  
अंदॆशॆ	expectation  
अंदेशे	expectation  
अंधकार	Darkness  
अंधा	blind  
अंधे	blinds  
अंपायर	Umpire  
अंबानि	ambani  
अंबानी	Ambani  
अंबॆडकर	ambedkar  
अंबेडकर	ambedkar  
अंर्तविरोध	internal conflict  
अंश	episode  
अंसारि	Ansari  
अंसारी	Ansari  
अकटुबर	october  
अकटॊबर	october  
अकतियार	wright  
अकतुबर	october  
अकबर	Akbar  
अकबार	News paper  
अकरम	Akram  
अकल	mind  
अकलपनिय	unimaginable
अकल्पनीय	unimaginable
अकशय	akshay  
अकशर	word  
अकशरदाम	akshardham  
अकसर	Usually  
अकसिजन	oxygen  
अकस्मात	 accidentally 
अकादमि	Academy  
अकादमिक	academic  
अकादमी	Academy  
अकाल	starvation  
अकेला	Alone  
अकेली	Alone  
अकेले	Alone  
अकेलेपन	Loneliness  
अक्खड	stubborn  
अक्खड़	stubborn  
अक्टूबर	October  
अक्टोबर	October  
अक्तुबर	October  
अक्तूबर	october  
अक्षय	Infinite
अक्षर	Letter  
अक्षरग्राम	akshargram  
अक्सर	Usually  
अक्सिजन	oxygen  
अखबार	News paper  
अखबारों	News paper  
अख़बार	News paper  
अखिल	Akhil  
अखिलेश	akhilesh  
अख्तर	Akhtar  
अख्तियार	wright  
अगं	organ  
अगनि	fire  
अगर	If  
अगरवाल	agarwal  
अगरसर	proceeding  
अगला	Next  
अगलि	next  
अगली	Next  
अगलॆ	next  
अगले	Next  
अगवा	Missing  
अगसत	august  
अगस्त	August  
अग्नि	fire  
अग्निरेखा	fire wall  
अग्निहोत्री	agnihotri  
अग्रवाल	Agrawal  
अग्रसर	proceeding  
अचानक	Suddenly  
अचार	pickle  
अचुक	accurate  
अचूक	accurate  
अच्छा	Good  
अच्छी	Good  
अच्छे	Good  
अछूत	untouchable  
अजनबि	stranger  
अजनबी	Stranger  
अजब	Strange  
अजमॆर	ajmer  
अजमेर	ajmer  
अजय	victorious  
अजययादव	ajay yadav  
अज़ीज़	dear  
अजान	call  
अजिज	dear  
अजित	Ajit  
अजीज	Ajit  
अजीत	Ajit  
अजीब	Strange  
अजीबोगरीब	strange  
अजेंडा	agenda  
अज्ञात	Hiding 
अज्ञान	unknown  
भारत	India
अज्ञेय	victorious  
अटक	cought  
अटकलॊं	remours  
अटटासि	eighty eight
अटरावॆ	eighteenth  
अटलबिहारि	atal bihari  
अटलबिहारी	atal bihari  
अटलांटिक	atlantic  
अटलांटिस	atlantis  
अटहततर	sixty eight  
अटारह	eighteen
अटारहवां	eighteenth
अटूट	Unbreakable  
अट्ठाईस	twenty eight
अट्ठानवे	ninety eight
अट्ठारह	eighteen  
अट्ठावन	fifty eight
अट्ठासी	eighty eight
अठरावा	eighteen
अठहत्तर	seventy eight
अठारह	eighteen
अठारहवां	eighteen
अडतालिस	fourty eight
अडतिस	thirty eight
अडसट	sixty eight
अड़तालीस	fourty eight
अड़तीस	thirty eight
अड़सठ	sixty eight
अडियॊ	immobile  
अडियो	immobile  
अड्डा	Location  
अड्डे	Location  
अड्डों	Location  
अणु	atom  
अतंकवादियॊं	terrorist  
अतंकवादियों	terrorist  
अतः	therefore  
अतरराशटरिय	international  
अतर्राष्ट्रीय	international  
अति	Extreme  
अतिथि	Guest  
अतिथी	guest  
अतिरिक्त	Additional  
अतीत	Beyond  
अतुल	Atul  
अत्यंत	Most  
अत्यथिक	Maximum  
अत्यधिक	Maximum  
अत्यन्त	Maximum  
अत्याचार	Abuse 
अत्याधुनिक	Latest  
अथवा	Otherwise  
अथिकतम	Maximum  
अथिकतर	Maximum  
अथिकांश	Most  
अथिकारियों	Officer  
अथिकारी	Officer  
अथिनियम	law  
अथेन्स	athens  
अथॉरिटी	authority  
अदयातम	spritual  
अदयातमिक	spritual  
अदयादॆश	orders  
अदयाय	Chapter  
अदरक	Ginger  
अदा	style  
अदालत	Court  
अदालतॆ	Court  
अदालते	Court  
अदालतों	Court  
अदिकार	right  
अदिकारि	Officer  
अदिकारियॊं	Officer  
अदिकारॊं	rights  
अदिति	aditi  
अदिती	aditi  
अदिनियम	law  
अदिलाबाद	adilabad  
अदिसुचन	notice  
अद्भुत	Wonderful  
अद्वितीय	second  
अधर्म	non religious  
अधिक	Most  
अधिकतम	Most  
अधिकतर	Most  
अधिकांश	Most  
अधिकार	Authority  
अधिकारपत्र	authority paper  
अधिकारियों	Authorities  
अधिकारी	Officer  
अधिकारों	Authorities  
अधिनियम	Most rules  
अधिवक्ता	speaker  
अधिवर्ष	year  
अधिसूचना	notice  
अधिसूचनाएं	notice  
अधूरा	Incomplete  
अधूरी	Incomplete  
अधूरे	Incomplete  
अधेंरे	Incomplete  
अध्यक्ष	Leader  
अध्यक्षता	Leadership  
अध्ययन	Study  
अध्यात्म	Spiritual  
अध्यात्मिक	Spiritual  
अध्यादेश	orders  
अध्यापक	Teacher 
अध्याय	Chapter  
अनंत	Infinite  
अनगिनत	Uncountable  
अनछुआ	untouched  
अनजानि	Unknown  
अनजाने	Unknown  
अनदेखा	unseen  
अनदेखी	Unseen  
अनदेखे	unseen  
अनन्त	Infinite  
अनपड	illiterate  
अनपढ	illiterate  
अनपॆकशित	unexpected  
अनपेक्षीत	unexpected  
अनबन	conflict  
अनमोल	Invaluable 
अनवर	Anwar  
अनसुलजि	unresolved  
अनसुलझी	unresolved  
अनहत्तर	sixty nine
अनाकोंडा	Anaconda  
अनाड़ी	naïve  
अनाडि	naïve  
अनाथ	orphan  
अनाथों	orphan  
अनामदास	anamdas  
अनारकलि	  anarkali  
अनारकली	  anarkali  
अनावश्यक	Unnecessary  
अनाड़ी	naïve  
अनिल	anil  
अनिवार्य	Unavoidable  
अनिवासि	non resident  
अनिवासी	non resident  
अनिशचित	indefinite  
अनिशचितत	indefinite  
अनिश्चित	indefinite  
अनिश्चितता	indefinite  
अनुकुल	favourable  
अनुकूल	Convenient  
अनुचित	Improper  
अनुदान	 donation
अनुप	anoop  
अनुपम	anupam  
अनुपसतिति	absence  
अनुपस्थिती	absence  
अनुपात	ratio  
अनुप्रयोग	experiment  
अनुबंध	Affection
अनुबव	anubhav  
अनुभव	Experience  
अनुभवी	Experience  
अनुभवों	Experience  
अनुभूत	Experience  
अनुभूति	Experience  
अनुभूतिका	Experience  
अनुभूतिय	Experience  
अनुभूतियाँ	Experience  
अनुभूतियों	Experience  
अनुमति	Permission  
अनुराग	anurag  
अनुराधा	anuradha  
अनुरॊद	Request  
अनुरोध	Request  
अनुवाद	Translate  
अनुशंसा	appriceate  
अनुशासन	Discipline  
अनुसंदान	institute  
अनुसंधान	Combine
अनुसार	According  
अनुसूचित	Notified  
अनूप	anoop  
अनूपमा	anupama  
अनूपशुक्ला	anoop shukla  
अनूभुति	feel  
अनूष्का	anushka  
अनॆक	Many  
अनेक	Many  
अनोखा	New  
अनोखी	New  
अन्त	End  
अन्तरजाल	network  
अन्तरराष्ट्रीय	international  
अन्तराष्ट्रिय	international  
अन्तरिक्ष	space  
अन्तरिम	interim  
अन्तर्जाल	network  
अन्तर्राज्यीय	interstate  
अन्तिम	Final  
अन्दर	Inside  
अन्धा	blind  
अन्धेरे	darkness  
अन्न	grain food  
अन्ना	brother  
अन्नान	Annan  
अन्य	Other  
अन्यथा	Otherwise  
अन्यान्य	Injustice  
अन्याय	Injustice  
अन्वर	anwar  
अन्सारी	ansari  
अप	Up  
अपगरॆड	upgrade  
अपगान	afgan  
अपगानसतान	afganistan  
अपगानि	afgani  
अपगानिसतान	afganistan  
अपग्रेड	upgrade  
अपजल	afzal  
अपडॆट	update  
अपडॆटः	update  
अपडेट	Update  
अपडेटः	update  
अपणी	ours  
अपन	we  
अपना	Our  
अपनाई	Used 
अपनाएँ	accept  
अपनाएं	accept  
अपनाना	Used 
अपनानॆ	accept  
अपनाने	Used 
अपनाया	Used  
अपनी	ours  
अपमान	Humiliation 
अपमानित	insulted  
अपरयापत	insuficient  
अपराद	crime  
अपरादबॊद	guilt  
अपरादि	criminal  
अपराध	crime  
अपराधबोध	guilt  
अपराधियों	Criminal  
अपराधी	Criminal  
अपराधों	Crimes  
अपरॆल	april  
अपरैल	april  
अपलाई	apply  
अपलॊड	upload  
अपलोड	upload  
अपहरण	Abduct
अपहर्ता	kidnapper  
अपान	our  
अपार	Limitless  
अपारटमॆंट	apartment  
अपार्टमेंट	apartment  
अपिल	appeal  
अपील	Appeal  
अपॆकश	Expect  
अपेक्शा	Expect  
अपेक्षा	Expect  
अपेक्षाकृत	Expect  
अपॉर्चुनिटी	opportunity  
अपॊलॊ	Apollo  
अपोलो	Apollo  
अप्रिय	disliked  
अप्रेल	april  
अप्रैल	April  
अप्लाई	apply  
अफगाणिस्तान	afganistan  
अफगाणिस्तानचे	afganistan  
अफगान	Afghan  
अफगानस्थान	afganistan  
अफगानियों	afgani  
अफगानिस्तान	Afghanistan  
अफगानी	afgani  
अफजल	afzal  
अफवाह	Rumor  
अफसर	Officer  
अफसरों	Officer  
अफ़ग़ान	Afghan  
अफ़ग़ानिस्तान	Afghanistan  
अफ़सर	officer  
अफ़ीम	opium  
अफ़्ग़ानिस्तान	Afghanistan  
अफ़्रिका	africa  
अफ़्रीका	Africa  
अफ़्रीकी	african  
अफीम	opium  
अफोर्ड	afford  
अफ्रिदी	afridi  
अफ्रीका	Africa  
अफ्रीकी	african  
अब	Now  
अबदुल	abdul  
अबबास	abbas  
अबयास	practice  
अबराहम	Abraham  
अबाउट	about  
अबाऊट	about  
अबिंयास	practice  
अबिनंदन	welcome  
अबिनव	Abhinav  
अबिनॆतरि	Actress  
अबियान	movement  
अबियानॊं	movement  
अबिशाप	curse  
अबिशॆक	abhishek  
अबिशॆकि	abhishek  
अबिसार	abhisar  
अबु	abu  
अबू	Abu  
अब्दुर्रहमान	abdul rehman  
अब्दुल	Abdul  
अब्दुल्ला	Abdulla  
अब्बास	Abbas  
अब्राहम	Abraham  
अभय	Fearless  
अभाव	Scarcity  
अभिजात	abhijit  
अभिजित	abhijit  
अभिजीत	abhijit  
अभिनंदन	welcome  
अभिनन्दन	welcome  
अभिनय	Acting  
अभिनव	Abhinav  
अभिनेता	Actor  
अभिनेत्री	Actress  
अभिमानी	proudy  
अभियंता	engineer  
अभियांत्रिकी	engineering  
अभियान	Program  
अभियानों	movement  
अभिशाप	curse  
अभिषेक	Abhishek  
अभिषेकी	abhisheki  
अभिसार	abhisaar  
अभूतपूर्व	Not Former  
अमन	Peace  
अमबॆडकर	ambedkar  
अमबॆदकर	ambedkar  
अमर	Amar  
अमरकांत	amarkant  
अमरत	 immortal potion 
अमरनात	Amarnath  
अमरनाथ	Amarnath  
अमरावति	amaravati  
अमरावती	amaravati  
अमरिकि	american  
अमरिकियॊं	american  
अमरीका	America  
अमरीकियों	american  
अमरीकी	America  
अमरुद	guava  
अमरूद	guava  
अमल	Implement  
अमांडा	Amanda  
अमानविय	inhuman  
अमानवीय	inhuman  
अमानुशिक	inhuman  
अमानुषिक	inhuman  
अमावस्या	Nomoon day  
अमित	amit  
अमिताब	Amitabh  
अमिताभ	Amitabh  
अमिरात	Emirates  
अमिषा	Amisha  
अमीर	Rich  
अमीरात	Emirates  
अमीषा	Amisha  
अमूमन	approximately  
अमृतलाल	amritlal  
अमृतवाणी	amritvani  
अमृतवानि	amritvani  
अमृतसर	Amritsar  
अमृता	Amrita  
अमॆजन	amazon  
अमॆटि	amity  
अमॆरिकन	american  
अमॆरिका	america  
अमॆरिकाः	america  
अमॆरिकि	american  
अमॆरिकियॊं	american  
अमेजन	amazon  
अमेठी	amity  
अमेरिकन	American  
अमेरिका	America  
अमेरिकाः	america  
अमेरिकियों	American  
अमेरिकी	American  
अमेरीकी	American  
अम्बेडकर	ambedkar  
अम्बेदकर	ambedkar  
अम्मा	mother  
अययर	aiyar  
अययुब	ayub  
अयुब	ayub  
अयूब	ayub  
अयोध्या	Ayodhya  
अय्यर	aiyer  
अय्युब	ayub  
अरचन	hinderence  
अरजंटिन	Argentina  
अरजुन	arjun  
अरतशासतरि	economist  
अरतात	Meaning
अरपन	Dedicated
अरब	Arab  
अरबन	urban  
अरबपति	billionare  
अरबपतियॊं	billionare  
अरबपतियों	billionare  
अरबवासियॊं	arabic  
अरबवासियों	arabic  
अरबि	arabic  
अरबिय	arabic  
अरबी	Arabic  
अरबों	Arabs  
अरविंद	Aravind  
अरविन	arvin  
अरविन्द	Aravind  
अरशद	arshad  
अरसे	ages  
अराफात	arafat  
अराफ़ात	arafat  
अरिहंत	arihant  
अरिहन्त	arihant  
अरुण	Arun  
अरुणा	aruna  
अरुणाचलप्रदेश	arunanchal pradesh  
अरुणिमा	arunima  
अरुन	arun  
अरुनाचल	arunanchal  
अरुनाचलपरदॆश	arunanchal pradesh  
अरुनिम	arunim  
अरूणाचल	arunanchal  
अरेबिया	arabia  
अरोरा	arora  
अर्घ्य	adharya  
अर्चना	Archana  
अर्जन्टीना	Argentina  
अर्जुन	Arjun  
अर्जेंटाईन	Argentina  
अर्जेंटिना	Argentina  
अर्जेंटीना	Argentina  
अर्जेन्टीना	Argentina  
अर्थतंत्र	economic system  
अर्थतन्त्र	economic system  
अर्थव्थवस्था	Financial situation
अर्थव्यवस्था	Financial situation  
अर्थशास्त्र	economics  
अर्थशास्त्री	economics  
अर्थात	meaning  
अर्धकुंभ	ardhkumb  
अर्पण	Dedicated  
अर्पित	Dedicated 
अर्शद	arshad  
अल	Al  
अलका	alka  
अलकायदा	Al qaeda  
अलग	Separate  
अलगाववादी	Separatists  
अलजिरिय	algeria  
अलजिरियन	algeria  
अलटिमॆटम	ultimatem  
कैफ	Kaif
कैबिनॆट	Cabinet
कैबिनेट	Cabinet
आया	Came
कैमरा	Camera
कैमरुन	Cameroon
कैमरून	Cameroon
कैमरॆ	Cameras
कैमरे	Cameras
कैमिकल	Chemical
कैम्प	Camp
कैम्पस	Campus
कैम्ब्रिज	Cambridge
कैराॅल	Carol
कैरियर	Career
कैरेक्टर	Character
कैरॊसिन	Kerosene
कैरोसिन	Kerosene
कैलंडर	Calendar
कैलाश	Kailash
कैलिफोर्निया	California
कैलॆंडर	Calendar
कैलेंडर	Calendar
कैलेन्डर	Calendar
कैसा	How
कैसी	How
कैसॆ	How
कैसे	How
कैसेट	Cassette
कैस्परस्की	Caspersky
कैफ़	Kaif
कॉँस्टेन्टिनोपल	Constantinople
कॉंट्रॅक्टर	Contractor
कॉन्सर्ट	Concert
कॉन्सेप्ट	Concept
कॉपी	Copy
कॉप्टर	Copter
कॉफी	Coffee
कॉम	Com
कॉमन	Common
कॉमिक्स	Comics
कॉमेडी	Comedy
कॉम्प्टन	Compton
कॉरिडोर	Corridor
कॉर्क	Cork
कॉर्पोरेट	Corporate
कॉर्प्स	Corpus
कॉल	Call
कॉलम	Column
कॉलराडो	Colarado
कॉलिंगवूड	Collingwood
कॉलिन	Collin
कॉलेज	College
कॉलेजों	College
कॉलोनी	Colony
कॉस्मेटिक	Cosmetic
कॊचिंग	Coaching
कॊचिन	Cochin
कॊट	Coat
कॊटक	Kotak
कॊडॆक	Codec
कॊडॆड	Coded
कॊन	Cone
कॊपनहागन	Copenhagan
कॊमल	Sensitive
कॊमॊडॊ	Comodo
कॊयंबतुर	Coimbatore
कॊयल	Cuckoo
कॊरस	Chorus
कॊरिय	Korea
कॊरियन	Korean
कॊल	Coal
कॊलंबस	Columbus
कॊलंबिय	Columbia
कॊलंबॊ	Columbo
कॊलगॆट	Colgate
कॊलार	Kolar
कॊलॊ	Kolo
कॊशिश	Try
कॊशिशॆं	Tries
को	to
कोइज़ुमी	Koizumi
कोइजुमी	Koizumi
कोइराला	Koirala
कोई	Someone
कोकाकोला	Cocacola
कोच	Coach
कोचिंग	Coaching
कोटक	Kotak
कोटी	Koti
कोट्टायम	Kottayam
कोड	Code
कोडेक	Codec
कोडेड	Coded
कोण	Angle
कोने	Corner
कोपनहागन	Copenhagan
कोफ़ी	Coffee
कोबाल्ट	Cobalt
कोम	Coma
कोमल	Sensitive
कोमा	Coma
कोमोडो	Comodo
कोयंबतूर	Coimbatore
कोयला	Cuckoo
कोरस	Chorus
कोरियन	Korean
कोरिया	Korea
कोरोला	Corolla
कोर्ट	Court
कोर्निकोवा	Kournikova
कोर्स	Course
कोलंबस	Columbus
कोलंबिया	Columbia
कोलंबो	Columbo
कोलकता	Kolkata
कोलकाता	Kolkata
कोलगेट	Colgate
कोलम्बिया	Columbia
कोला	Cola
कोलार	Kolar
कोल्हापुर	Kolhapur
कोल्हापुरी	Kolhapur
कोल्हापूर	Kolhapur
कोश	Treasure
कोशिश	Effort
कोशिशें	Effort
कोशिशों	Effort
कोस्ट	Coast
कोस्टर	Coaster
कोह्लापुर	Kohlapur
कौआ	Crow
कौओं	Crow
कौन	Who
कौमुदि	Koumudi
कौर	Kaur
कौरव	kaurav
कौल	Kaul
कौशल	Kaushal
कौशल्या	Kaushalya
कौशिक	Kaushik
क्या	What
क्याल्सियम	Calcium
क्युरियम	Curium
क्युरी	Curie
क्यूँ	Why
क्यूं	Why
क्यूंकि	Because
क्यूटी	Cutie
क्यूबा	Cuba
क्यूबिकल	Cubical
क्यों	Why
क्योंकि	Because
क्रम	Line
क्रांति	Revolution
क्रांतिकारी	Rebellion
क्राइस्टचर्च	ChristChurch
क्रान्ति	Revolution
क्रान्तिकारी	Rebellion
क्राफ्टेड	Crafted
क्राफ्ट्स	Crafts
क्रिकेट	Cricket
क्रिकेटर	Cricketer
क्रिकेटरों	Cricketer
क्रिप्टन	Krypton
क्रिया	Verb
क्रियाएँ	Verb
क्रियापद	Verb
क्रियाविशेषण	Adverb
क्रियेटिव	Creative
क्रिस	Chris
क्रिसमस	Christmas
क्रिस्टियन	Christian
क्रिस्टोफर	Christopher
क्रीक	Creek
क्रीडा	Sport
क्रीम	Cream
क्रुक	Crook
क्रेग	Craig
क्रेज	Craze
क्रेजी	Crazy
क्रेडिट	Credit
क्रोएशियन	Croatian
क्रोएशिया	Croatia
क्रोध	Anger
क्रोमियम	Chromium
क्लब	Club
क्लबों	Clubs
क्लर्क	Clerk
क्लाइंट	Client
क्लार्क	Clark
क्लास	Class
क्लासमेट	Classmate
क्लासरूम	Classroom
क्लासिक	Classic
क्लाॅक	Clock
क्लिंटन	Clinton
क्लिओपात्रा	Cleopatra
क्लिक	Click
क्लीन	Clean
क्लीनिंग	Cleaning
क्लॉड	Clod
क्लॉडियस	Claudius
क्लोन	Clone
क्लोनडीवीडी	CloneDVD
क्लोनसीडी	CloneCD
क्लोनिंग	Cleaning
क्लोरीन	Chlorine
क्वार्टर	Quarter
क्वालालमपुर	Kualalampur
क्वालिटी	Quality
क्वीन	Queen
क्वीन्स	Queens
क्वीन्सबरी	Queensbury
क्षण	Second
क्षणों	Seconds
क्षति	Speed
क्षमता	Capacity
क्षमताओं	Capacity
क्षमा	Forgive
क्षमादान	Forgive
क्षितिज	Kshitij
क्षेत्र	Region
क्षेत्रीय	Regional
क्षेत्रों	Region
क॑पनियां	Companies
क॑पनियों	Companies
क॑पनी	Company
क॑प्यूटर	Computer
कड़ा	Hard
कड़ी	Hard
कड़े	Hard
खंड	Segment
खंडकाव्य	Composition
खंडन	Segmentation
खंडेलवाल	Khandelwal
खगोल	Globe
खगोलशास्त्र	Geography
खजूर	Dates
खटक	Cuttack
खड़ा	Stand
खड़ी	Stand
खड़े	Stand
खडा	Stand
खडी	Stand
खडे	Stand
खण्ड	Continent
खतम	Complete
खतरनाक	Dangerous
खतरा	Danger
खतरे	Danger
खत्	Letter
खदान	Mine
खनिज	Mineral
खन्ना	Khanna
खपत	Consumption
खबर	News
खबरपत्रिका	Newspaper
खबरे	News
खबरें	News
खबरों	News
खम्मम	Khammam
खयाल	View
खरगोश	Pigeon
खरगोशों	Pigeon
खरा	Pure
खराब	Damaged
खराबी	Damaged
खरीद	Buy
खरीदते	Buy
खरीददारी	Shopping
खरीदना	Buy
खरीदने	Buy
खरीदा	Bought
खरीदारी	Shopping
खरीदी	Bought
खरीदे	Bought
खरीदें	Bought
खरीदेंगे	Bought
खरीदेगा	Buy
खरीदो	Buy
खरे	Khare
खर्च	Spend
खर्चा	Cost
ख़तरनाक	Dangerous
ख़तरा	Danger
ख़तरे	Danger
ख़बर	News
ख़बरें	News
ख़बरों	News
ख़राब	Spoilt
ख़रीद	Buy
ख़रीदारी	Shopping
ख़रीदारों	Shopping
ख़र्च	Consumption
ख़ास	Special
ख़िलाफ़	Against
ख़ुद	Self
ख़ुदा	God
ख़ुफ़िया	Secret
ख़ुश	Happy
ख़ुशी	Happiness
ख़ून	Blood
ख़्वाहिश	Wish
ख़्वाहिशें	Wish
खा	Eat
गुफायें	caves
सुंदर	beautiful
तट	beaches
पहाड़ी	hill
स्थल	place
बौद्धों	buddhist
वाटर	water
रैफ्टिंग	rafting
सूर्य	sun
पर्वतारोहण	trekking
सभा-भवन	hall
पर्यटन	tourism
आकर्षण	attraction
खाँसी	Cough
खाई	Valley
खाए	Ate
खाएँ	Eat
खाएं	Eat
खाओ	Eat
खाकर	eat
खाड़ी	Gulf
खाता	Account
खातिर	Sake
खाती	Eat
खाते	Accounts
खातों	Accounts
खाद्य	Eatable
खाध्य	Eatable
खानदानी	Generation
खानपान	Food
खाना	Food
खाने	eat
खानेवाले	eaters
खामोश	Silence
खामोशी	Silence
खाया	Ate
खारिज	Reject
खाली	Empty
खास	Special
खासकर	Mainly
खासतौर	Mainly
खासा	Special
खासियत	Speciality
खासी	Special
खासे	Special
खाड़ी	Gulf
खिचड़ी	Mixture
खिचडी	Mixture
खिड़की	Window
खिताब	Honor
खिताबी	Honor
खिलवाड़	Playing
खिला	Blossom
खिलाड़ियों	Players
खिलाड़ी	Player
खिलाफ	Against
खिलाड़ियों	Players
खिलाड़ी	Player
खिली	Blossom
खिसक	Slide
खिसकने	Slide
खिसका	Slide
खिड़की	Window
खींच	Pull
खुद	Self
खुदकुशी	Suicide
खुदरा	Change
खुदा	God
खुदाई	Digging
खुफिया	Secret
खुफियागिरी	Secretiveness
खुराना	Khurana
खुल	Open
खुलकर	open
खुलती	Open
खुलने	Open
खुला	open
खुली	open
खुले	open
खुलेगा	open
खुश	Happy
खुशखबरी	Happy news
खुशबू	Scent
खुशवंत	Khushwant
खुशालसिंह	KhushalSingh
खुशियाँ	Happiness
खुशियां	Happiness
खुशियों	Happiness
खुशी	Pleasure
खून	Blood
खूब	Abundant
खूबसूरत	Beautiful
खूबसूरती	Beauty
खूबियों	Virtues
खेत	Farm
खेती	farming
खेतीबाड़ी	Farming
खेतों	Farms
खेद	Sorry
खेल	Sport
खेलकर	play
खेलकूद	Sports
खेलते	Play
खेलना	Play
खेलने	Play
खेला	Play
खेली	Play
खेले	Play
खेलेंगे	play
खेलेगा	play
खेलो	Play
खेलों	Sports
खैर	ok
खोई	Lost
खोकर	lose
खोखो	Kho-Kho
खोज	Search
खोजकर्ताओं	Scientists
खोजने	search
खोजी	search
खोजे	search
खोजें	Search
खोपरा	Dried coconut
खोया	Lost
खोल	Open
खोलकर	Open
खोलने	Open
खोला	open
खोली	open
खोले	open
खोलेगा	open
खोलो	Open
खोसला	Scam
ख्याति	Fame
ख्याल	Thoughts
ख्वाब	Dream
ख्वाबों	Dreams
ख्वाहिश	Wish
ख्वाहिशें	Wishes
खज़ाना	Treasure
खड़ा	Stand
खड़ी	Stand
खड़े	Stand
गंगा	Ganga 
गंगाधर	Gangadhar
गंगानगर	Ganganagar
गंजा	Bald
गंदक	Sandalwood
गंदगी	Dirtyness
गंदा	Bad
गंदे	Dirty
गंध	Smell
गंधर्व	Angels
गंभीर	Bold
गंभीरता	Boldness
गई	Went
गए	Went
गगन	Sky
गज	Elephant
गजपति	Mahout
गजब	Amazing
गजल	Ghazal
गजलकार	Singer
गजलॆं	Ghazals
गजलॊं	Ghazals
गजानन	Lord ganesh
गजुरात	gujarat 
गठन	Make
गठबंधन	Tie up
गठबन्धन	Tie up
गठित	Made
गडबड	Confused
गड़बड़ी	Confusion
गड्ढे	Hole, Drainage
गणतंत्र	Republic
गणतन्त्र	Republic
गणतन्त्रको	Republic
गणतन्त्रवादी	Supporters of Republic
गणना	Counting
गणपति	Lord ganesh
गणपतीबाप्पा	Lord ganesh
गणित	Mathematics
गणितज्ञ	Mathematician
गणेश	lord ganesh
गणेशजी	lord ganesh
गणेशा	lord ganesh
गणेशोत्सव	Lord Ganesh Festival
गत	Former
गति	Rate
गतिरोध	Deadlock
गतिविथियों	Cabinet
गतिविधि	Movement
गतिविधियाँ	Movements
गतिविधियां	Movements
गतिविधियों	Movements
गद्य	A kind of music
गद्यकार	Musician
गद्यगान	Songs
गधों	Donkeys
गनमैन	Gunmen
गन्दा	Bad
गन्धक	Sandalwood
गपशप	Chat
गम	Sad
गमन	Pace
गम़	Sad
गम्भीर	Bold
गया	Went
गयाना	Guyana
गयी	Went
गये	Went
गरज	shout
गरम	Hot
गरमी	Heat
गरिमा	Proud
गरीब	Poor
गरीबी	Poverty
गरीबों	Poor
गर्ग	Garg
गर्दन	Neck
गर्भ	Womb
गर्भवती	Pregnant
गर्मियों	Summer
गर्मी	Summer
गर्लफ़्रेंड	Girl Friend
गर्लफ्रेंड	Girl Friend
गर्व	Pride
गर्वगीत	Songs of pride
गलत	Wrong
गलतियां	Mistakes
गलतियॊं	Mistakes
गलतियों	Mistakes
गलती	Mistake
गला	Neck
गलियां	Streets
गलियों	Streets
गली	Street
गले	Necks
गल्फ़	Gulf
गवर्नर	Governor
गवर्नर्स	Governors
गवा	Witness
गवाह	Witness
गवाही	Witness
गवाहॊं	Witnesses
गवाहों	Witnesses
गहन	Deep
गहरा	Deep
गहराई	Deepness
गहरी	Deep
गहरॆ	Deep
गहरे	Deep
ग़ज़ल	Ghazal
ग़ज़लें	Ghazals
ग़ज़लों	Ghazals
ग़ौरतलब	Heck
गाँधी	Gandhi
गाँधीगिरी	Principles of Gandhi
गाँधीगीरी	Principles of Gandhi
गाँधीवाद	Gandhism
गाँव	Village
गाँवों	Villages
गांजालॆज	Gonzalez
गांधर्वी	Angel
गांधी	Gandhi
गांधीगिरी	Principles of Gandhi
गांधीजी	Gandhiji
गांधीनगर	Gandhinagar
गांव	Village
गांववालॊं	Villagers
गांववालों	Villagers
गांवॊं	Villages
गांवों	Villages
गाइड	Guide
गाइडॆंस	Guidance
गाइडेंस	Guidance
गाए	Sang
गाएं	Cows
गाजर	Carrot
गाजिपुर	Ghajipur
गाजियाबाद	Ghajiyabad
गाजीपुर	Ghajipur
गाड़ी	Vehicle
गाणे	Songs
गाता	Sing
गाते	Sing
गाना	Sing
गानॆ	Sing
गाने	Sing
गानों	Songs
गान्धी	Gandhi
गाय	Cow
गायक	Singer
गायत्री	Gayatri
गायब	Invisible
गाया	Sang
गायिका	Singer
गारंटी	Guarantee
गार्ड	Guard
गार्डनर	Gardener
गार्डन्स	Garden
गार्सिया	Garcia
गालियाँ	Curse
गालियॊं	Curse
गालियों	Curse
गाली	Curse
गालीलेओ	Galileo
गावसकर	Gavaskar
गासिप	Gossip
गाड़ी	Vehicle
गिनती	Counting
गिबसन	Gibson
गिब्स	Gibbs
गिर	Fall
गिरता	Fall
गिरतॆ	Fall
गिरते	Fall
गिरनॆ	Fall
गिरने	Fall
गिरफ़्तार	Arrest
गिरफ़्तारियाँ	Arrest
गिरफ्तार	Arrest
गिरफ्तारी	Arrest
गिरा	Fall
गिराए	Fall
गिरानॆ	Fall
गिराने	Fall
गिराया	Fall
गिरावट	Decrease
गिरि	Giri
गिरिराज	Giriraj
गिरिराजजॊशि	Giriraj joshi
गिरिराजजोशी	Giriraj joshi
गिरिश	Girish
गिरी	Fall
गिरीश	Girish
गिरॆ	Fall
गिरे	Fall
गिरेगा।	Fall
गिरॊह	Band
गिरोह	Band
गिरौदपुरि	Giraudpuri
गिरौदपुरी	Giraudpuri
गिलक्रिस्ट	Gilchrist
गिलहरि	Squirrels
गिलहरियों	Squirrels
गिलहरी	Squirrel
गिलास	Glass
गिलेस्पी	Gillespie
गिल्बर्ट	Gilbert
गिविंग	Giving
गिविन्ग	Giving
गीत	Song
गीतकार	Singer
गीतपर्व	Verse
गीतमाला	Album
गीता	Geetha
गीतांजली	Gitanjali
गीतिका	Song
गीतों	Songs
गुंजन	Gunjan
गुंजाइश	Scope
गुजजु	Gujju
गुजर	Pass
गुजरतॆ	Pass
गुजरना	Pass
गुजरने	Pass
गुजरात	Gujarat
गुजराति	Gujarati
गुजराती	Gujarati
गुजराल	Gujral
गुज्जु	Gujju
गुट	Group
गुटनिरपेक्ष	Group
गुटॊं	Groups
गुटों	Groups
गुड	Egg
गुडियॊं	Brides
गुण	Quality
गुणता	Quality
गुणवत्ता	Quality
गुणात्मक	Quality
गुणों	Quality
गुना	Multiply
गुप्त	Secret
गुप्ता	Gupta
गुप्ते	Secret
गुफा	Cave
गुरु	Teacher
गुरुकुल	Gurukul
गुरुजी	Master
गुरुजीको	Master
गुरुदयाल	Master
गुरुदॆव	Master
गुरुवार	Thursday
गुरू	Teacher
गुल	Dimple
गुलज़ार	Guljaar
गुलजार	Guljaar
गुलजारबाग	Guljaarbagh
गुलजा़र	Guljaar
गुलमॊहर	Gulmohar
गुलमोहर	Gulmohar
गुलशन	Gulshan
गुल़ज़ार	Guljaar
गुलाब	Rose
गुलाबि	Pink
गुलाबी	Pink
गुलाम	Slave
गुलामी	Slavery
गुलज़ार	Guljaar
गुलज़ारबाग	Guljaarbagh
गुवाहाटि	Guwahati
गुवाहाटी	Guwahati
गुस्सा	Anger
गुस्से	Angry
गुड़	Jaggery
गुड़गांव	Gudgeon
गुड़िया	Doll
गुड़ियों	Doll
गूँज	Echo
गूंज	Echo
गूंजने	Echo
गूगल	Google
गृह	Home
गृहमंत्री	Home minister
गृहयुद्ध	Homefight
गॅलिलियो	Galileo
गॆंद	Ball
गॆंदबाजि	Bowl
गॆंदॆं	Balls
गॆटवॆ	Gateway
गॆटस	Gates
गेंद	Ball
गेंदबाज	Bowler
गेंदबाज़ी	Bowling
गेंदबाजी	Bowling
गेंदबाजों	Bowlers
गेंदें	Balls
गेंदों	Balls
गेट	Gate
गेटवे	Gateway
गेट्स	Gates
गेब्रियेल	Gabriel
गेम	Game
गेम्स	Games
गेल	Gayle
गेहूँ	Wheat
गेहूं	Wheat
गैप	Gap
गैर	Allen
गैलरी	Gallery
गैलिलियो	Galileo
गैलेक्सी	Galaxy
गैस	Gas
गैसॊं	Gas
गैसों	Gas
गॉडफ्रे	Godfrey
गॉफ	Gough
गॊकलॆ	Gokale
गॊदावरि	Godavari
गॊपाल	Gopal
गॊपालदास	Gopaldas
गॊपाळराव	Gopalrao
गॊपिनात	Gopinath
गॊयल	Goyal
गॊरकपुर	Gorakhpur
गॊरकपुरि	Gorakhpuri
गॊरडन	Gordon
गॊलि	Marble
गॊलियां	Marble
गॊविंद	Govind
गॊविंदसिंह	Govindsinh
गॊविंदाचारय	Govindacharya
गॊसवामि	Goswami
गोआ	Goa
गोखले	Gokhale
गोद	Lap
गोदावरी	Godavari
गोधरा	Godhra
गोपनीय	Secret
गोपनीयता	Secrecy
गोपाल	Gopal
गोपालदास	Gopaldas
गोपाळराव	Gopalrao
गोपीनाथ	Gopinath
गोयल	Goyal
गोरखपुर	Gorakhpur
गोरखपुरी	Gorakhpuri
गोरखा	Gorakha
गोरिल्ला	Gorilla
गोर्डन	Gordon
गोल	Goal
गोलकीपर	Goalkeeper
गोलघर	Goal
गोलरहित	Goalless
गोला	Sphere
गोलियाँ	Bullets
गोलियां	Bullets
गोली	Bullet
गोलीबारी	Shooting
गोले	Bombs
गोलों	Bombs
गोल्ड	Gold
गोल्डन	Golden
गोल्फ	Golf
गोवा	Goa
गोविंद	Govind
गोविंदसिंह	Govindsinh
गोविंदा	Govinda
गोविंदाचार्य	Govindacharya
गोवित्रिकर	Govitrikar
गोविन्द	Govind
गोशन	Goshan
गोष्ट	Ghost
गोस्वामी	Goswami
गोहाटी	Gowhati
गौतम	Goutam
गौतमि	Gouthami
गौतमी	Gouthami
गौर	See
गौरतलब	Heck
गौरव	Pride
गौरवशाली	Proud
गौरवसॊलंकि	Gauravsolanki
गौरवसोलंकी	Gauravsolanki
गौरी	Gouri
ग्यारह	Eleven
ग्रंथ	Book
ग्रंथालय	Library
ग्रस्त	Affected
ग्रह	Planet
ग्रहण	Eclipse
ग्रांड	Grand
ग्रान्ड	Grand
ग्राफ	Graph
ग्राम	Village
ग्रामीण	Villager
ग्रामीणों	Villagers
ग्राहक	Customer
ग्राहकी	Customers
ग्राहकों	Customers
ग्राहम	Graham
ग्राफ़	Graph
ग्रीक	Greek
ग्रीटिंग्स	Greetings
ग्रीन	Green
ग्रीनलैंड	Greenlined
ग्रीनहाउस	Greenhouse
ग्रीन्सबर्ग	Greensberg
ग्रीष्म	Cold
ग्रीस	Grease
ग्रीसचे	Grease
ग्रॅहॅम	Graham
ग्रे	Grey
ग्रेग	Greg
ग्रेगरी	Gregory
ग्रेगोरी	Gregory
ग्रेट	Great
ग्रेटर	Greater
ग्रेड	Grade
ग्रेनेड	Grenade
ग्रैंड	Grand
ग्रोवर	Grover
ग्लेशियर	Glacier
ग्लैमर	Glamor
ग्लैमरस	Glamorous
ग्लॉस्टरशायर	Gloustershire
ग्लोब	Globe
ग्लोबल	Global
ग्वालियर	Gwalior
गज़नी	Ghajini
गज़ल	Ghajal
गड़बड़	Confusing
गड़े	Clocks
गढ़	Bastion
घंटा	Hour
घंटियों	Bell
घंटी	Bell
घंटे	Hours
घंटों	Hours
घई	Ghai
घटक	Part
घटकर	Decrement
घटती	Decrease
घटना	Incident
घटनाएँ	Incidences
घटनाएं	Incidences
घटनाओं	Incidences
घटनाक्रम	Affair
घटनायें	Incidences
घटनास्थल	Venue
घटने	Incidents
घटा	Decreased
घटाकर	Decrement
घटिया	Waste
घड़ी	Watch
घन	Dense
घनत्व	Density
घबरा	Tentative
घबराती	Tentative
घमासान	Horrific
घर	House
घरवालों	Family
घरों	Homes
घाघरा	Dress
घाट	Valley
घाटी	Valley
घाटे	Valley
घातक	Dangerous
घाना	Ghana
घायल	Injured
घाव	Wound
घास	Grass
घी	Ghee
घुटने	Knee
घुटनों	Knees
घुमाएंगे	Visit
घुमाया	Visit
घुस	Enter
घुसने	Enter
घुसपैठ	Intruder
घूम	Reel
घूमता	Circulate
घूमती	Circulate
घूमते	Circulate
घूमने	Circulate
घृणा	Hate
घेर	Surround
घेरा	Surround
घेराबंदी	Surrounded
घोंसला	Nest
घोटाला	Shamble
घोटाले	Shambles
घोड़ा	Horse
घोड़े	Horses
घोडे	Horses
घोर	Dark
घोल	Solution
घोष	Gosh
घोषणा	Announcement
घोषणाएँ	Announcements
घोषित	Announced
घोड़े	Horses
घड़ी	Watch
चँपियन्स	Champions
चंडीगढ	Chandigarh
चंडीगढ़	Chandigarh
चंडीगढ़	Chandigarh
चंद	Few
चंदन	Sandalwood
चंदु	Chandu
चंदू	Chandu
चंद्र	Moon
चंद्रपूर	Chandrapur
चंद्रभूषण	Chandrabhushan
चंद्रमा	Moon
चंद्रशेखर	Chandrasekhar
चकमा	Outwit
चकित	Surprised
चक्र	Circular
चक्रधर	Chakradhar
चक्रधरसिंह	Chakradharsimh
चक्रबर्ती	Emperor
चक्रवर्ती	Emperor
चटनी	Pickle
चटपटा	Frustrated
चटर्जी	Chatterjee
चटर्जी।	Chatterjee
चट्टोपाध्याय	Chattopadhyaya
चढने	Climb
चढ़	Climb
चढ़ा	Climb
चढ़े	Climb
चतुर	Intelligent
चतुरत	Intelligent
चतुर्थी	chaturdhi
चतुर्वेदी	Chaturvedi
चना	Gram
चने	Grams
चन्द्र	Moon
चन्द्रगुप्त	ChandraGupt
चन्द्रनिगाहपुर	Chandranigahpur
चन्द्रबिन्दु	Chandrabindu
चन्द्रमा	Moon
चन्द्रलालपुर	Chandralalpur
चन्द्रशेखर	Chandrashekhar
चपरासि	Servant
चमक	Shine
चमकती	Shining
चमकदार	Shining
चमकनॆ	Shining
चमकने	Shining
चमका	Shine
चमत्कार	Magic
चमत्कारी	Magician
चम्बल	Chambal
चम्मच	Spoon
चयन	Selection
चयनित	Selected
चरक	Charak
चरखा	Spinning Wheel
चरण	Feet
चरणों	Feet
चरम	Peak
चरित्र	History
चर्च	Church
चर्चगेट	Churchgate
चर्चा	Discussion
चर्चाको	Discussion
चर्चित	Mentioned
चर्चिल	Churchill
चर्म	Skin
चल	Walk
चलकर	Walk
चलकॆ	Walk
चलता	Walk
चलती	Walk
चलतॆ	Walk
चलते	Walk
चलन	Trend
चलना	Walk
चलनॆ	Walk
चलने	Walk
चला	Walked
चलाइए	Walk
चलाई	Run
चलाईं	Run
चलाए	Walk
चलाएं	Walk
चलाएगा	Walk
चलातॆ	Run
चलाते	Run
चलाना	Run
चलानॆ	Run
चलाने	Run
चलाया	Ran
चलिए	Walk
चलिये	Walk
चली	Walk
चलॆं	Walk
चले	Walk
चलें	Walk
चलेंगे	Walk
चलेगा	Walk
चलेगी	Walk
चलो	Lets go
चवालिस	Forty Four
चवालीस	Forty Four
चव्हाण	Chauhan
चशमॆं	Glasses
चश्मा	Glasses
चश्में	Glasses
चाँद	Moon
चाँदनी	Moon
चाँदी	Silver
चांटॊ	Chanting
चांद	Moon
चांदनी	Moonlight
चांदी	Silver
चाइना	China
चाइनीज़	Chinese
चाइल्ड	Child
चाकलॆट	Chocolate
चाकलेट	Chocolate
चाकु	Knife
चाकू	Knife
चाचा	Uncle
चाची	Aunt
चाणक्य	Chanakya
चाद	Chad
चादर	Bed sheet
चान्द	Moon
चामाराजानगर	Chamaraja nagar
चाय	Tea
चार	Four
चारपाई	Carpet
चारा	Way
चारॊं	All four
चारों	All four
चार्ज	Charge
चार्टर	Charter
चार्ली	Charlie
चार्ल्स	Charles
चाल	Ploy
चालक	Driver
चालीस	Forty
चालु	Clever
चालू	Clever
चावल	Rice
चावला	Chawla
चाह	Want
चाहत	Interest
चाहता	Want
चाहती	Want
चाहतॆ	Wants
चाहते	Want
चाहना	Want
चाहनॆ	Want
चाहने	Want
चाहा	Want
चाहिए	Want
चाहियॆ	Want
चाहिये	Want
चाहे	Like
चाहेंगे	Like
चाहेगा	Like
चाहो	Like
चाॅकलेट	Chocolate
चिंगारियां	Sparks
चिंतन	Think
चिंता	Worry
चिंताएं	Worries
चिंताओं	Worries
चिंतामणि	Chintamani
चिंतित	Worried
चिंमयानंद	Chinmayanand
चिकित्सक	Doctor
चिकित्सकों	Doctors
चिकित्सा	Treatment
चिकित्साशास्त्र	Medicine
चिगुम्बरा	Chigumbara
चिट्ठा	Details
चिट्ठाः	list
चिट्ठियां	Letters
चिट्ठी	Letter
चिडिया	Bird
चित्र	Picture
चित्रकला	Drawing
चित्रकार	Artist
चित्रकूट	Chitrakoot
चित्रण	Depiction
चित्रपट	Portrait
चित्रलेखा	Drawing
चित्रहार	Collection of movies
चित्रा	Chitra
चित्रित	Depicted, Picturised
चित्रों	Pictures
चिदंबरम	Chidambaram
चिदंबरम्	Chidambaram
चिदानंद	Chidanand
चिन्तन	Think
चिन्ता	Worry
चिन्ताएं	Worries
चिन्मयानंद	Chinmayanand
चिन्ह	Symbol
चिप	Hide
चिपचिपॆ	Hiding
चिपनॆ	Hide
चिपानॆ	To hide
चिपॆ	Hidden
चिरंजीव	Long live
चिलि	Chile
चिल्लाने	Shout
चिड़िया	Bird
चिड़ियां	Birds
चीकी	Cheeky
चीज	Thing
चीज़	Thing
चीज़ें	Things
चीज़ों	Things
चीजें	Things
चीजों	Things
चीन	China
चीनी	Sugar
चीफ	Chief
चुंबक	Magnet
चुआंग	Chuang
चुका	Returned
चुकाने	To return
चुकी	Returned
चुकॆ	Had
चुके	Had
चुटकी	Quick
चुटकुला	Joke
चुटकुलॆ	Jokes
चुटकुले	Jokes
चुड	Escape
चुडाए	Escape
चुडानॆ	To get someone out
चुन	Choose
चुननॆ	Choose
चुनने	Choose
चुना	Chose,Chosen
चुनाव	election
चुनावी	Election
चुनावॊं	Elections
चुनावों	Elections
चुनिंदा	Elected
चुनिए	Elect
चुनी	Chosen
चुनॆ	Chosen
चुने	Chosen
चुनौतियॊं	Challenges
चुनौतियों	Challenges
चुनौती	Challenge
चुनौतीपूर्ण	Challengeful
चुप	Silent
चुपकॆ	silent
चुपके	silent
चुपचाप	silent
चुपानॆ	To hide
चुपि	Hidden
चुप्पी	Silence
चुराएं	To steal
चुराना	Steal
चूँकि	Because
चूंकि	Because
चूक	Decieved
चूमा	Touch
चूल्हा	Stove
चूहा	Rat
चूहे	Rats
चूहों	Rats
चॆतन	Motivation
चॆहरॆ	Faces
चेक	Cheque
चेकोस्लोवाकिया	Czechoslovakia
चेतन	Motivation
चेतना	Motivation
चेतावनी	Warning
चेन्नई	Chennai
चेम्बरलेन	Chamberlane
चेयरमैन	Chairman
चेल्सी	Chelsea
चेहरा	Face
चेहरे	Face
चेहरों	Faces
चैंपियंस	Champions
चैंपियन	Champion
चैंपियनशिप	Championship
चैंप्स	Champs
चैन	Ease
चैनल	Channel
चैनलों	Channels
चैनल्स	Channels
चैपल	Chappel
चैम्पियंस	Champions
चैम्पियन	Champion
चैम्पियनशिप	Championship
चैलॆंज	Challenge
चैलेंज	Challenge
चैलेंजर	Challenge
चॉकलेट	Chocolate
चॊट	Wound
चॊटानागपुर	Chota Nagpur
चॊटु	Small
चॊटॆ	Small
चॊड	Leave
चॊडकर	Left
चॊडनॆ	To leave
चॊडॆंगॆ	Will leave
चॊडॊ	Leave
चॊरॊं	Thieves
चोट	Wound
चोटी	Peak
चोर	Thief
चोरी	Theft
चोरों	Thieves
चौंकनॆ	Astonished
चौंकाने	Suddenly
चौंतीस	Thirty-four
चौंसठ	Sixty-four
चौक	Astonished
चौकी	Watchful
चौके	Fours
चौकों	Fours
चौथा	Fourth
चौथाई	One fourth
चौथी	Fourth
चौथे	Fourth
चौदरि	Chowdary
चौदह	Fourteen
चौदहवाँ	Fourteenth
चौबीस	Twenty four
चौरानवॆ	Ninety-four
चौरानवे	Ninety-four
चौरासी	Eighty-four
चौवन	Fifty-four
चौहत्तर	Seventy-four
चौहान	Chauhan
च्यालेन्ज	Challenge
चढ़	Climb
चढ़ा	Climb
चढ़ेगी	Climb
छः	Six
छक्के	Sixer
छठा	Sixth
छठी	Sixth
छठे	Sixth
छड़ी	whip
छत	Roof
छत्	Roof
छत्तिसगढ	Chattisgarh
छत्तीस	Thrity six
छत्तीसगढ	Chattisgarh
छत्तीसगढ़	Chattisgarh
छत्तीसगढ़	Chhatisgarh
छत्रपती	Sivaji
छप	Print
छपता	print
छपाइये	print
छपी	Print
छप्पन	Fifty six
छब्बीस	Twenty six
छलनी	Filter
छलांग	Bounce
छल्ले	Rings
छवि	Image
छवी	Sixth
छह	Six
छाई	Spread
छाए	Spread
छाओ	Spread
छाती	Chest
छात्र	Student
छात्रवृत्ति	Student
छात्रा	Student
छात्रों	Students
छानबीन	Investigation
छाप	Print
छापते	Print
छापने	Print
छापा	Print
छापामार	Raid
छापामारों	Raids
छापे	Raids
छापें	Raids
छापों	Printings
छाया	Shadow
छायाचित्र	Photograph
छायाचित्रकार	Photographer
छायाचित्रे	Photographs
छिप	Hide
छिपछिपे	Hide
छिपने	Hide
छिपा	Hidden
छिपाने	Hide
छिपाया	Hide
छिपे	Hidden
छियानवे	Ninety six
छियालीस	Forty six
छियासठ	Sixty six
छियासी	Eighty six
छिहत्तर	Seventy six
छीन	Snatch
छीलिए	shave
छु	Touch
छुट	omit
छुटकारा	Relief
छुट्टन	relief
छुट्टियां	Holiday
छुट्टियों	Holiday
छुट्टी	Holiday
छुट्टे	tips
छुड़ाए	discharge
छुड़ाने	discharge
छुड़ाया	discharge
छुप	Hide
छुपा	Hide
छुपाने	Hide
छुपी	Hidden
छू	Touch
छूट	Free
छूटी	Free
छूने	Touch
छे	six
छेड़	tease
छेड़ते	tease
छेड़ने	tease
छेड़ा	tease
छेड़े	tease
छेडी	tease
छेद	Hole
छेड़ने	tease
छेड़ी	tease
छोटा	Small
छोटी	Small
छोटू	Small
छोटे	Small
छोटो	Small
छोड	Discard
छोड़	Discard
छोड़कर	Except
छोड़ना	Leave
छोड़ने	Leave
छोड़ा	Left
छोड़ी	Left
छोड़े	Left
छोड़ेंगे	leave
छोड़ेगा	leave
छोड़ो	leave
छोडा	leave
छोर	Corner
छोड़	Discard
छोड़कर	Except
छोड़ना	Leave
छोड़ने	Leave
छोड़ा	Left
छोड़ी	Left
छोड़ें	Leave
छोड़ो	Leave
जंक	junk
जंक्	junk
जंग	War
जंगल	Forest
जंगलि	uncivilized
जंगली	uncivilized
जंगलॊं	Forests
जंगलों	Forests
जंतु	Animal
जकार्ता	Jakarta
जख्मी	Injured
जग	world
जगजित	Jagjit
जगजीत	Jagjit
जगत	World
जगति	World
जगती	World
जगत्	World
जगदिश	Jagdeesh
जगदिशपरसाद	Jagdeesh Prasad
जगदिशबाटिय	Jagdeesh Bhatia
जगदीप	Jagdeep
जगदीश	Jagdeesh
जगदीशभाटिया	Jagdeesh Prasad
जगन्नाथ	Jagannath
जगमॊहन	Jagmohan
जगमोहन	Jagmohan
जगह	Place
जगहों	Places
जगाउन	Places
जगाचय	Place
जगाच्या	Place
जगातॆ	awake
जगाते	awake
जगुआर	Jaguar
जज	Judge
जज्बा	Intention
जञात	know
जञान	knowledge
जञानकॊश	treasure of knowledge
जञानजॊत	light of knowledge
जञानपरकाश	Gyan Prakash
जञानपिट	Gyanpeeth
जञानरंजन	knowledge
जञानसंदुक	violation
जञानॆंदर	Gyanendra
जञानॆंदरकॊ	Gyanendra
जञानॆशवर	possessing knowledge
जञानॆशवरि	possessing knowledge
जञानॊदय	enlightenment
जञापन	remembering
जटिल	Complicated
जड़	root
जड़ें	root
जता	understand
जताई	understand
जताते	understand
जताय	understand
जताया	understand
जन	Person
जनक	father
जनकपुर	Janakpur
जनकपुरि	Janakpuri
जनकपुरी	Janakpuri
जनकलयान	welfare of people
जनकल्याण	welfare of people
जनकवि	people's poet
जनगणना	census
जनगनतव	census
जनगनन	census
जनघनत्व	census
जनजाति	tribe
जनजातिय	tribal
जनजातीय	tribal
जनजीवन	daily life
जनता	People
जननि	mother
जननी	mother
जनप्रिय	beloved
जनम	birth
जनमत	People opinion
जनरल	General
जनरलॊं	General
जनरलों	General
जनवरि	January
जनवरी	January
जनसंकय	Population
जनसंख्या	Population
जनसंघ	society
जनसंचार	crowd
जनसंहार	mass killing
जनसंहारक	mass killer
जनाब	sir
जनॆऊ	sacrificial thread
जनेऊ	sacrificial thread
जन्	people
जन्तु	animal
जन्म	Birth
जन्मदाता	Parent
जन्मदिन	Birthday
जन्मदिनको	Birthday
जन्मदिनमा	Birthday
जन्मदिवस	Birthday
जन्मभूमिः	Birthplace
जन्माष्टमी	Janmashtami
जन्मे	Born
जन्मोत्सव	birthday
जपान	Japan
जपानचॆ	Japan
जपानचे	Japan
जपानि	Japanese
जपानी	Japanese
कब	When
जबकि	Then
जबरदसत	Excellent
जबरदस्त	Excellent
जबरन	Forced
जबर्दस्त	Excellent
जबलपुर	Jabalpur
जबसॆ	from then
जबसे	from then
जबान	Promise
जबानि	Promise
जबानी	Promise
जब्त	Seize
जमकर	fitting
जममु	Jammu
जमशॆद	Jamshed
जमशॆदजि	Jamshedji
जमशॆदपुर	Jamshedpur
जमशेद	Jamshed
जमशेदजी	Jamshedji
जमशेदपुर	Jamshedpur
जमा	Submit
जमानत	Bail
जमानतॊं	Bail
जमाना	collect
जमानॆ	collect
जमाने	collect
जमाय	collect
जमाया	collect
जमीन	Field
जमुई	Jamui
जमैका	Jamica
जमैकाचॆ	Jamica
जमैकाचे	Jamica
जम्मू	Jammu
जम्शेदपुर	Jamshedpur
जय	win
जयंत	welfare
जयंति	anniversary
जयंती	anniversary
जयचंद	Jai Chand
जयजयकार	praise
जयदॆव	Jayadev
जयदेव	Jayadev
जयनंदन	Jaya Nandan
जयनगर	Jaynagar
जयन्त	Jayanth
जयन्ति	Jayanth
जयपरकाश	Jaya prakash
जयपुर	Jaipur
जयप्रकाश	Jaya prakash
जयमाल	Jaya mala
जयमाला	Jaya mala
जयललिता	Jaya lalitha
जयशंकर	Jaya Shankar
जयशरि	Jayashree
जयश्री	Jayashree
जयसूर्या	Jayasurya
जया	Jaya
जयुलियस	Julius
जयॆशट	elder
जयॊति	light
जयॊतिराव	Jyoti Rao
जयॊतिश	Astrologer
जयॊतिशशासतराचॆ	Astrology
जयॊतिशहरुकॊ	Astrologer
जरकॊनियम	Zirconium
जरमन	German
जरमनि	Germany
जरमॆनियम	Germanium
जरसि	Jersey
जरा	Little
जरास	Little
जरासा	Little
जरिए	Medium
जरिया	Medium
जरिये	Medium
जरुर	Must
जरुरत	Need
जरुरतॊं	Need
जरुरि	Must
जरुरी	Must
जरूर	Must
जरूरत	Need
जरूरतों	Need
जरूरी	Must
जर्कोनियम	Zirconium
जर्दा	scented tobacco
जर्मन	German
जर्मनी	Germany
जर्मेनियम	Germanium
जर्सी	jersey
जल	Water
जलतॆ	burn
जलते	burn
जलद	fast
जलदबाजि	Hurry
जलदि	fast
जलन	burning
जलना	burning
जलव	burning
जलवा	burning
जलवायु	climate
जला	Burn
जलाओ	Burn
जलाने	Burn
जलाय	Burn
जलाया	Burn
जलायॆ	Burn
जलाये	Burn
जलियाँवाला	Jallianwalah
जलियांवाल	Jallianwalah
जलियांवाला	Jallianwalah
जले	burn
जल्	water
जल्द	Quick
जल्दबाजी	Hurry
जल्दी	Quickly
जवलंत	burning
जवागल	Javagal
जवान	Young
जवानि	Youth
जवानिय	Youth
जवानी	Youth
जवानॊं	Youngsters
जवानों	Youngsters
जवाब	Reply
जवाबि	Reply
जवाबी	Reply
जवालामुकि	volacano
जवाहर	Jawahar
जवाहरलाल	Jawahar Lal
जशपुर	Jashpur
जश्न	Celebration
जसट	just
जसटिन	Justin
जसटिस	justice
जसदॆव	Jasdev
जसदेव	Jasdev
जसपाल	Jaspal
जसराज	Jasraj
जसवंत	Jaswant
जस्ट	just
जस्टिस	justice
जस्टीन	Justin
जहर	Poison
जहरिलि	poisonous
जहरिलॆ	poisonous
जहरीली	poisonous
जहरीले	poisonous
जहाँ	There
जहां	Jehangir
जहांगिर	Jehangir
जहांगीर	Jehangir
जहांनाम	Jahanama
जहांनामा	Jahanama
जहाज	Ship
जहाज़	Ship
जहान	where
जहिर	Jaheer
जहीर	Jaheer
ज़बान	tongue
ज़माना	time
ज़माने	time
ज़मीन	Field
ज़रा	little
ज़रिए	apart
ज़रीस	apart
ज़रुरत	requirement
ज़रूर	must
ज़रूरत	requirement
ज़रूरी	must
ज़हर	poison
ज़ाम्बिया	Zambia
ज़िंदगी	life
ज़िंदा	alive
ज़िक्	mention
ज़िक्र	mention
ज़िन्दग़ी	life
ज़िन्दगी	life
ज़िम्बाबवे	Zimbabwe
ज़िम्बाब्वे	Zimbabwe
ज़िम्मेदार	Responsible
ज़िम्मेदारी	Responsibility
ज़िले	district
ज़ीवन	life
ज़ुल्फिकार	Zulfikar
ज़ुल्फों	hair
ज़ोर	loud
ज़्यादा	many
ज़्यादातर	Mostly
ज़्यूरिख़	Zurich
जा	Go
जाँ	Go
जाँच	Check
जांकिए	know, find out
जांग	knowing
जांच	Check
जांचकरत	Check
जांचकरताओं	Check
जांचकर्ता	Check
जांचकर्ताओं	Check
जांबिय	Zambia
जांसन	Johnson
जाइए	Go
जाइयॆ	Go
जाइये	Go
जाईन	Jain
जाउंगा	Go
जाऊँ	Go
जाऊँगी	Go
जाऊं	Go
जाऊंगि	Go
जाए	Go
जाएँ	Go
जाएँगी	Go
जाएँगे	Go
जाएं	Go
जाएंगी	Go
जाएंगॆ	Go
जाएंगे	Go
जाएग	Go
जाएगा	Go
जाएगि	Go
जाएगी	Go
जाओ	Go
जाओं	Go
जाओंगॆ	Go
जाओंगे	Go
जाओगॆ	Go
जाओगे	Go
जाकर	Go
जाकिर	Zakir
जाग	Wakeup
जागता	Awake
जागतिक	Awake
जागनॆ	Awake
जागने	Awake
जागरण	Awakening
जागरन	Awakening
जागरुकता	Awareness
जागरूकता	Awareness
जागिए	awake
जागिर	manor
जागीर	manor
जागृत	Awakening
जागृति	Awakening
जागॆ	awake
जागे	awake
जागे।	awake
जाचक	check
जाड	winter
जात	Caste
जाता	Go
जाति	Caste
जातिं	Caste
जातिय	national
राष्ट्रीय	national
उद्यान	park
मूर्तिकला	sculptures
मंदिर	temple
देवी	goddess
पाक विधि	Cuisine
गज	elephant
यात्रा	tour travel
सौंदर्य	beauty
नैसर्गिक	virgin
गणेशोत्सव	ganesh festival
किलें	fort
शक्तिशाली	mighty
पहाड़ी	hill
दर्शनीय	site
स्थल place station

जातियॊं	Castes
जातियों	Castes
जातिवाद	racism
जाती	go
जातीं	go
जातीय	Communal
जातॆ	go
जाते	go
जादु	Magic
जादुई	Magic
जादुगर	Magician
जादुगरनि	Witch
जादुगरनी	Witch
जादू	Magic
जादूगर	Magician
जान	Life
जानकर	Known
जानकार	Knowledgeable
जानकारि	Information
जानकारिक	Information
जानकारियां	Informations
जानकारियॊं	Informations
जानकारियों	Informations
जानकारी	Information
जानकारीका	Information
जानत	Know
जानता	Know
जानति	Know
जानती	Know
जानतॆ	Know
जानते	Know
जानन	Know
जानना	Know
जाननॆ	Know
जानने	Know
जानलॆव	Horrible
जानलेवा	Horrible
जानवर	Animal
जानवरॊं	Animal
जानवरों	Animals
जाना	Go
जानां	Go
जानिए	Know
जानॆ	let
जानॆं	let
जानॆमन	dear
जाने	dear
जानें	dear
जानेमन	dear
जानॊ	understand
जानो	understand
जाप	praying
जापड	slap
जापान	Japan
जापानबासि	Japanese
जापानबासी	Japanese
जापानि	Japanese
जापानिज	Japanese
जापानियॊं	Japanese
जापानियों	Japanese
जापानी	Japanese
जापानीज	Japanese
जाफ़री	Jaffery
जाम	Goblet
जामनगर	Jamnagar
जामबिय	Zambia
जामा	pool
जामिनि	sour milk
जामिनी	sour milk
जामिय	sour milk
जामुन	Jamun
जाम्बिया	Zambia
जाय	go
जायंट	joint
जायज	Loyal
जायजा	Inspection
जायसवाल	Jaiswal
जाया	Waste
जायॆ	go
जायॆं	go
जायॆंगि	go
जायॆंगॆ	go
जायॆग	go
जाये	go
जायें	go
जायेंगी	go
जायेंगे	go
जायेगा	go
जायेगी	go
जारकंड	Jharkand
जारज	George
जारजिय	Georgia
जारजियाचॆ	Georgia
जारडन	Jordan
जारि	Continue
जारी	Continue
जार्ज	George
जार्जिया	Georgia
जार्डन	Jordan
जाल	trap
जालंदर	Jalandhar,cistern
जालंधर	Jalandhar,cistern
जालन	grudge
जालना	burn
जालसतल	trap
जालस्थल	trap
जाला	web
जालि	fake
जाली	network
जावई	going
जावा	going
जावॆद	Javed
जावेद	Javed
जासुसि	Detection
जासूस	Detection
जासूसी	Detection
जाहन	where
जाहिर	Express
जाहिरा	Express
जिंक	Zinc
जिंटा	Zinta
जिंदगि	Life
जिंदगी	Life
जिंदल	Jindal
जिंदा	Alive
जिंदादिल	open-hearted
जिंहॆं	who
जिकर	Mention
जिक्र	Mention
जिजञास	Curiosity
जिजञासु	Curiosity
जिज्ञासा	Curiosity
जिज्ञासु	Curiosity
जितना	Whatever
जितनि	Whatever
जितनी	Whatever
जितनॆ	Whatever
जितने	Whatever
जितॆंदर	Jitender
जितेन्द्र	Jitendra
जिद	Craze
जिदंगि	life
जिदंगी	life
जिदर	Where
जिधर	Where
जिन	whose
जिनका	whose
जिनकी	whose
जिनकॆ	whose
जिनके	whose
जिनको	whose
जिनमें	whose
जिनसे	whose
जिनॆटिक	Genetic
जिनेटिक	Genetic
जिन्दगी	Life
जिन्दा	alive
जिन्ना	Jinna
जिन्हें	who
जिन्होंने	who
जिपिऍल	GPL
जिम	Jim
जिममॆदार	responsible
जिममॆदारि	responsibility
जिम्बाबवे	Zimbabwe
जिम्बाब्वे	Zimbabwe
जिम्मेदार	Responsible
जिम्मेदारी	Responsibility
जियॊपारडि	Jeopardy
जियोपार्डी	Jeopardy
जिरह	Cross examination
जिला	District
जिले	Districts
जिलों	Districts
जिल्ला	District
जिवनचरित	life history
जिवनदान	sacrifice
जिस	which
जिसका	whose
जिसकि	whose
जिसकी	whose
जिसके	whose
जिसकॊ	whose
जिसको	whose
जिसनॆ	who
जिसने	who
जिसम	Body, passion
जिसमॆं	where
जिसमें	where
जिसस	which
जिससॆ	by which
जिससे	by which
जिसॆ	whom
जिसे	whom
जिस्म	Body
जिहाद	holy war
जींस	Jeans
जीत	Win
जीतकर	Win
जीतना	Win
जीतने	Win
जीता	Win
जीती	Win
जीतीं	Win
जीते	Win
जीतेंद्र	Win
जीतेगा	Win
जीतेन्दर	Jitender
जीतेन्द्र	Jitendra
जीना	Live
जीनियस	Genius
जीने	live
जीप	Jeep
जीभ	Tongue
जीये	live
जीयो	live
जीरा	Cumin
जीव	Being
जीवजंतु	living beings
जीवन	Life
जीवनचरित	life history
जीवनदान	sacrifice
जीवनशैली	Lifestyle
जीवनसाथी	Life partner
जीवशास्त्र	biology
जीवाश्म	Fossll
जीवित	Life
जीविता	Life
जीवों	Beings
जीसस	which
जुड	Combine
जुडतॆ	Combine
जुडन	Combine
जुड़	Combine
जुड़ते	Combine
जुड़ना	Combine
जुड़ा	Combine
जुड़ी	Combine
जुड़े	Combine
जुडि	Combine
जुडिशियल	Judicial
जुडी	Combine
जुडीशियल	Judicial
जुडॆ	Combine
जुडॆं	Combine
जुनियर	Junior
जुबान	Promise
जुलाई	July
जुलाए	July
जुलियट	Juliet
जुलियस	Julius
जुड़	Combine
जुड़ा	Combine
जुड़ी	Combine
जुड़े	Combine
जूठे	false, wrong
जूता	Shoes
जूते	Shoes
जून	June
जूनियर	Junior
जूलियट	Juliet
जूही	Juhi
जॆओमॆटरि	Geometry
जॆटमलानि	Jethmalani
जॆनिंगस	Jennings
जॆनॆटिक	Genetic
जॆनॆरिक	Generic
जॆपरसन	Jefferson
जॆरालड	Gerald
जॆरुसलम	Jerusalem
जॆरुसलॆम	Jerusalem
जॆरॊम	Jerome
जेओमेट्री	Geometry
जेट	Jet
जेटली	Jaitley
जेठमलानी	Jethmalani
जेन	Zen
जेनरेशन	Generation
जेनिंग्स	Jennings
जेनेटिक	Genetic
जेनेरिक	Generic
जेपी	Janta party
जेफरसन	Jefferson
जेफरी	Geoffery
जेब	Pocket
जेम्स	James
जेराल्ड	Gerald
जेरुसलम	Jerusalem
जेरुसलेम	Jerusalem
जेरूसलम	Jerusalem
जेरोम	Gerome
जेल	Jail
जेलों	Jails
जेहन	Mind
जेफ़रसन	Jefferson
जैक	Jaik
जैकी	Jaikee
जैकेट	Jacket
जैक्शन	Jackson
जैक्सन	Jackson
जैन	Jain
जैनि	Jain
जैनी	Jain
जैनेन्द्र	Jainendra
जैविक	Biological
जैसा	Like
जैसि	Like
जैसी	Like
जैसॆ	Like
जैसे	Like
जैहिंद	Jai Hind
जॉन	Johnny
जॉनी	Johnny
जॉर्ज	George
जॉर्जिया	Georgia
जॉर्जियाचे	Georgia
जॉर्डन	Jordan
जॉल	trap
जॊक	joke
जॊड	combine
जॊडन	combine
जॊडनॆ	combine
जॊडि	pair
जॊर	force
जॊरज	George
जॊरजिय	Georgia
जॊरडन	Jordan
जॊरडनकॊ	Jordan
जॊरदार	loud
जॊशि	Joshi
जॊसॆप	Joseph
जो	Who
जोंस	Jonse
जोखिम	Risk
जोज़फ़	Joseph
जोड	Add
जोडना	Add
जोड़	Add
जोड़ा	Add
जोड़ी	Add
जोधपुर	Jodhpur
जोर	Force
जोरदार	Force
जोर्ज	George
जोर्जिया	Georgia
जोर्डन	Jordan
जोर्डनको	Jordan
जोश	Excitement
जोशी	Joshi
जोस	Enthusiasm
जोसेफ	Joseph
जोसेफ़	Joseph
जोहूर	Johar
जोड़	Add
जोड़कर	Add
जोड़ने	Add
जोड़ा	Add
जोड़ी	Couple
जोड़े	Couples
जौन	John
जौनपुर	Jaunpur
जौरज	George
जौर्ज	George
जौहर	Jouhar
ज्ञात	Known
ज्ञान	Knowledge
ज्ञानकोश	treasure of knowledge
ज्ञानजोत	light of knowledge
ज्ञानपीठ	Gyanpeeth
ज्ञानप्रकाश	Gyanprakash
ज्ञानरंजन	Knowledge
ज्ञानसन्दूक	violation
ज्ञानेंद्र	Gyanendra
ज्ञानेन्द्र	Gyanendra
ज्ञानेन्द्रको	Gyanendra
ज्ञानोदय	wise
ज्ञापन	Memory
ज्याक्सनद्वारा	Jackson
ज्यादा	More
ज्यादातर	Mostly
ज्यानमार्ने	killing
ज्यानुवरी	January
ज्युलियस	Julius
ज्यूपिटर	Jupiter
ज्येष्ठ	Eldest
ज्यॉफ्री	Jaffery
ज्यो	who
ज्यों	who
ज्योति	Light
ज्योतिर्गमय	Lightning
ज्योतिष	Astrologer
ज्योतिषशास्त्राचे	Astrology
ज्योतीराव	Jyotirao
ज्वलंत	burning
ज्वालामुखी	volcano
जड़	Root
जड़े	set
झँडा	Flag
झंकृत	chime
झंझावत	chime
झंडी	Flags
झंडे	Flags
झकास	superb
झगड़ा	Quarrel
झगड़े	Quarrel
झगडा	Quarrel
झटका	Stroke
झटके	Stroke
झटकों	Stroke
झड़प	Contention
झड़पें	Contention
झड़पों	Contention
झड़ी	flag
झत्का	stroke
झन्ना	cramped
झपकते	Nap
झपकी	Nap
झप्पी	hug
झरना	Waterfall
झरोखा	Small window
झरोखे	Small window
झरोखोँ	Small window
झरोखों	Small window
झलक	Flash
झलकियाँ	Flash
झहीर	Zaheer
झाँकी	peep show
झाँसी	Jhansi
झांकती	peep
झांकिए	peep
झांकेगा	peep
झांबिया	Zambia
झांसी	Jhansi
झाकिर	Zakir
झाकीर	Zakir
झाङे	Trees
झाड	Trees
झाडा	Trees
झाडाझडती	Trees
झापड	slap
झापा	basket
झाबुआ	scuttle
झायेद	Zayed
झार	drizzle
झारखंड	Jharkhand
झाली	sharp
झाले	sharp
झालो	sharp
झाड़	Trees
झिम्बाब्वे	Zimbabwe
झिम्बाब्वेचे	Zimbabwe
झील	lake
झीलँड	lake
झीलँडचे	lake
झुंड	stream
झुंडों	stream
झुक	Bend
झुकने	Bend
झुकाने	Bend
झुकी	Bend
झुकेंगे	Bend
झुल्फिकार	Zulfikar
झूकने	bend
झूठ	Lie
झूठा	Lie
झूठी	Lie
झूम	swing
झेकोस्लोव्हेकिया	Czechoslovakia
झेल	Bear
झेलना	Bear
झेलम	Jhelum
झेलिये	Bear
झेवियर	Xavier
झोंबी	zombie
झोली	Bag
झोले	Bag
झ्यूस	juice
टंक	Type
टंकन	Type
टंकलॆकन	Typewriter
टंकलॆकनाचि	Typewriter
टंकलेखन	Typewriter
टंकलेखनाची	Typewriter
टंगसटन	Tugsten
टंग्स्टन	Tugsten
टंजानिय	Tanzania
टंजानिया	Tanzania
टंडन	Tandan
टंडॆ	cool
टंबललागः	Quarrel
टंबललॉगः	Quarrel
टकक	Injection
टककर	Accident
टकन	Injection
टकनॊलॊजि	Technology
टकरा	Clash
टकराई	Clash
टकरातॆ	Clash
टकराते	Clash
टकराव	Clash
टक्कर	Accident
टक्का	Accident
टखना	Ankle
टटॊरियल	Tutorial
टटॊल	To feel
टटॊलॊ	To feel
टटोरियल	Tutorial
टटोल	To feel
टटोलो	To feel
टन	Ton 
टप	toss
टपप	toss
टमाटर	Tomato
टमाटरॊं	Tomato
टमाटरों	Tomato
टयुनिशिय	Tunisia
टयुनिशियाई	Tunisia
टयुनिसिय	Tunisia
टयुब	Tube
टयुबलाइट	Tube Light
टयुरिंग	Turing
टयुलिप	Tulip
टयुशन	Tution
टयूशन	Tution
टर	yell
टरक	Disappear
टरकि	Turkey
टरकॊं	Turkey
टरनर	Turner
टरबियम	Trubium
टरमपर	Tramper
टरमिनॆटर	Terminatior
टरसटिशिप	trusteeship
टरांस	Trans
टरांसडयुसरस	transducer
टरांसपर	Transfer
टरांसलिटरॆशन	Translation
टरापिक	Tropic
टराम	Tram
टरायकॊस	Traicos
टरायल	Trail
टरि	Tree
टरिकस	tricks
टरिनिडाड	Trinidad
टरिपल	triple
टरिबयुनल	Tribunal
टरिम	Trim
टरिलियन	Trillion
टरिशिटर	Tristar
टरुप	Troup
टरुमन	Truman
टरॆक	Trek
टरॆकिंगचय	trekking
टरॆजॆडि	tragedy
टरॆड	Trade
टरॆन	Train
टरॆनॊं	Train
टरॆलर	trailer
टरैवॆल	Travel
टर्की	Turkey
टर्नर	Turner
टर्मिनेटर	Terminator
टल	move away
टला	move away
टलाः	move away
टली	move away
टलुअई	move away
टलुआ	move away
टविकिंग	Tweaking
टविटर	Tweeter
टवॆंटि	Twenty
टवैन	Twain
टहराएंगॆ	Stand
टहराय	Stand
टहरायॆंगॆ	Stand
टहरि	Stand
टहरॆ	Stand
टाँग	Leg
टांग	Leg
टांजानिय	Tanzania
टांझानिया	Tanzania
टाइगरस	Tiger
टाइगर्स	Tiger
टाइटल	Title
टाइटानियम	Titanium
टाइप	Type
टाइपराइटर	Typewriter
टाइपिंग	Typing
टाइम	Time
टाइमम	Time
टाइममा	Time
टाइमस	Times
टाइम्स	Times
टाइल	Tile
टाई	Tie
टाईटन	Titan
टाईम	Time
टाईमजॊन	Timezone
टाईमपास	Timepass
टाईमस	Times
टाईम्	Time
टाईम्स	Times
टाईमज़ोन	Timezone
टाउन	Town
टाउनसॆंड	Townsend
टाउनसेन्ड	Townsend
टाक	talk
टाकरॆ	Thakre
टाकिया	Takiya
टाकुर	Thakur
टाटा	Tata
टाडा	TADA
टाढा	TADA
टाण्टलम	Tantilum
टानटलम	Tantilum
टाप	Top
टापर	Topper
टापिक	Topic
टायटनिक	Titanic
टायटॅनिक	Titanic
टायटॆनिय	Titanic
टायटेनिया	Titanium
टारपुल	Turpul
टारफुला	Turful
टाल	defer
टालसटाय	Tolstoy
टाला	defer
टालॆ	defer
टालॊ	defer
टालो	defer
टावर	Tower
टासमानिय	Tasmania
टासमानिया	Tasmania
टाॅप	Top
टाॅय	Toy
टाॅस	Toss
टि	Tea
टिंग	Ting
टिक	durability
टिकट	Ticket
टिकर	stumble
टिकरित	stumble
टिका	durability
टिकाऊ	Durable
टिकान	durability
टिकानॆ	durability
टिकानॊं	durability
टिकिटिंग	Ticketing
टिकी	durable
टिच	teach
टिचर	teacher
टिडिं	Team
टिडीं	Team
टिन	Tin
टिप	Tip
टिपटन	Tipton
टिपपनि	Note
टिपपनियां	Note
टिपपनियॊं	Note
टिपस	Tips
टिपु	Tipu
टिप्	tips
टिप्पणियाँ	Note
टिप्पणियां	Note
टिप्पणियों	Note
टिप्पणी	Note
टिप्स	Tips
टिबि	TB
टिम	team
टिमकॊ	team
टिमको	team
टिमस	teams
टिवि	TV
टि॰वि॰	TV
टी	Tea
टीका	Injection
टीकाकरण	Injection
टीके	Injection
टीचर	Teacher
टीन	Teen
टीनेजर	Teenager
टीप	point
टीपू	Tippu
टीप्	point
टीम	Team
टीमें	Team
टीमों	Teams
टीमोर	Timore
टीम्स	Teams
टीवी	TV
टी॰वी॰	TV
टु	to
टुअर	tour
टुकड़ी	piece
टुकड़ो	piece
टुकडि	piece
टुकडॆ	piece
टुकडे	piece
टुकडॊ	piece
टुकराई	knock
टुकराए	knock
टुकराओ	knock
टुकरानॆ	knock
टुकराय	knock
टुकड़ा	Piece
टुकड़े	Pieces
टुगॆदर	together
टुगेदर	together
टुट	Break
टुटकॆ	Break
टुटके	Break
टुटतॆ	Break
टुटनॆ	Break
टुटि	Break
टुडॆ	today
टुतपॆसट	toothpaste
टुनिशिय	Tunisia
टुनिशिया	Tunisia
टुर	tour
टुरनामॆंट	Tournament
टुरिजम	tourism
टुरिज्म	tourism
टुलबाकस	toolbox
टुलबार	toolbar
टुलस	tools
टू	to
टूअॅर	tour
टूट	Break
टूटते	Break
टूटने	Break
टूटा	Break
टूटी	Break
टूटे	Break
टूडे	today
टूथपेस्ट	toothpaste
टूर	tour
टूर्नामेंट	Tournament
टूल	tool
टूलबार	Toolbar
टूल्स	tools
टॅक्नोलोजी	Technology
टॆंपॊ	tempo
टॆकनालॊजि	Technology
टॆकनिशियम	technetium
टॆकनॊलाजि	technology
टॆकसास	Texas
टॆकसासचय	Texas
टॆकसि	Taxi
टॆगॊर	Tagore
टॆडिंगटन	Tedington
टॆनिस	Tennis
टॆमपल	Temple
टॆमपलॆट	Template
टॆमस	Times
टॆलर	Tailor
टॆलिपॊन	Telephone
टॆलिबिजन	Television
टॆलिबिजनम	Television
टॆलिमाकस	Telemachus
टॆलुरियम	Telurium
टॆशन	Tension
टॆसट	Test
टॆसटिंग	Testing
टॆसटिग	Testing
टेंगर	Tiger
टेंपो	Tempo
टेंशन	Tension
टेक	rest
टेक्निशियम	technetium
टेक्नॉलोजी	Technology
टेक्नोलाॅजी	Technology
टेक्नोलॉजी	Technology
टेक्सास	Texas
टेक्सासच्या	Texas
टेक्सी	Taxi
टेक्स्ट	Text
टेगोर	Tagore
टेड	Ted
टेडिंगटन	Tedington
टेड्डी	Teddy
टेन	Ten
टेनिस	Tennis
टेनिसन	Tennis
टेप	Tape
टेबल	Table
टेम्पल	temple
टेम्प्लेट	template
टेम्स	times
टेरेंस	Terrace
टेरेसा	Teresa
टेलर	Tailor
टेलिफोन	Telephone
टेलिभिजन	Television
टेलिभिजनमा	Television
टेलिमाकस	Telemachus
टेलिविजन	Television
टेलिविज़न	Television
टेलीकास्ट	Telacast
टेलीफ़ोन	Telephone
टेलीफोन	Telephone
टेलीविजन	Television
टेलीविज़न	Television
टेलीविज़न	Television
टेलीस्कोप	Telescope
टेलुरियम	Telurium
टेस्ट	Test
टेस्टिंग	Testing
टेस्टिग	Testing
टेस्ला	Tesla
टै	Tie
टैंकरॊं	Tanker
टैंकरों	Tanker
टैंकॊं	tanker
टैंकों	tank
टैकनॊराति	Technorati
टैकनॊलॊजि	Technology
टैकस	Tax
टैकसट	Text
टैकसि	Taxi
टैक्नोराती	Technorati
टैक्नोलोजी	Technology
टैक्स	Tax
टैक्सी	Taxi
टैग	tag
टैगिंग	tag
टैगॊर	Tagore
टैगोर	Tagore
टैनिस	Tennis
टैपिंग	Typing
टैपिंगःकितनि	Typing
टैपिंगःकितनी	Typing
टैमपलॆट	Template
टैम्पलेट	Template
टैम्प्लेट	Template
टैलर	tailor
टॉक	Talk
टॉप	Top
टॉम	Tom
टॉय	Toy
टॉल्	defer
टॉल्स्टॉय	Tolstoy
टॉस	Toss
टॊंक	Talk
टॊंग	Leg
टॊकन	Token
टॊकयॊ	Tokyo
टॊकर	Cheat
टॊकरि	Cheat
टॊकियॊ	Cheat
टॊन	Tone
टॊनि	Tony
टॊबैगॊ	Tobbago
टॊयॊट	Toyota
टॊरंटॊ	Toronto
टॊरवलडस	Torvalds
टॊरॊंटॊ	Toronto
टॊल	Quarter
टॊलि	body
टोंगा	Tonga
टोकन	Token
टोकरी	Cheat
टोकियो	Tokyo
टोक्यो	Tokyo
टोगो	Togo
टोन	tone
टोनी	Tony
टोयोटा	Toyota
टोरंटॊ	Toronto
टोरवल्ड्स	Torvalds
टोरोंटो	Toronto
टोला	Quarter
टोली	Band
टोह	Search
ट्युनिसिया	Tunisia
ट्युरिंग	Turing
ट्यूनीशिया	Tunisia
ट्यूनीशियाई	Tunisia
ट्यूब	tube
ट्यूबलाइट	tubelight
ट्यूरिंग	Turing
ट्यूलिप	Tulip
ट्रंक	Trunk
ट्रक	Truck
ट्रकों	Trucks
ट्रस्ट	Trust
ट्रस्टीशिप	Trustyship
ट्राँसलिट्रेशन	Transliteration
ट्रांस	Trans
ट्रांसफर	Transfer
ट्रांसलिटरेशन	Transliteration
ट्रांस्ड्यूसर्स	transducer
ट्रांसफ़र	transfer
ट्रान्सलिट्रेशन	Transliteration
ट्राफिक	Traffic
ट्राम्	Tram
ट्रायकोस	Tricose
ट्रायल	Trial
ट्राॅफी	Trophy
ट्राफ़िक	traffic
ट्राफ़ी	trophy
ट्रिक्स	Tricks
ट्रिनिडाड	Trinidad
ट्रिपल	Triple
ट्रिब्यूनल	Tribunal
ट्रिम	Trim
ट्रिलियन	Trillion
ट्री	Tree
ट्रेक	trek
ट्रेकींगच्या	trekking
ट्रेजेडी	Tragedy
ट्रेड	tread
ट्रेन	Train
ट्रेनिंग	Training
ट्रेनों	Train
ट्रेलर	Trailer
ट्रैकबैक	Trekbike
ट्रैवेल	Travel
ट्विटर	Tweeter
ट्वीक	Tweek
ट्वीकिंग	tweaking
ट्वेंटी	Twenty
ट्वैन	Twine
ठंड	Cool
ठंडा	Cool
ठंडी	Cool
ठंडे	Cool
ठंढे	Cool
ठगों	Cheat
ठप	stamp
ठप्प	stamp
ठहराएंगे	waiting
ठहराया	wait
ठहरायेंगे	wait
ठहरी	wait
ठहरे	wait
ठहाका	peal
ठाकरे	Thackeray
ठाकुर	Thakur
ठाठ	retinue
ठाणे	police station
ठिकाण	Place
ठिकाने	Place
ठिकानों	Place
ठिठुरता	shiver
ठीक	Correct
ठीकरा	reject
ठुकरा	reject
ठुकराई	reject
ठुकराए	reject
ठुकराओ	reject
ठुकराने	reject
ठुकराया	reject
ठूंठ	stump
ठेके	contract
ठेकेदार	contractor
ठेकेदारों	contractor
ठोस	solid
डंकन	duncan
डंड	club
डंडा	club
डगमग	waver
डगमगा	waver
डगलस	Douglas
डग्लस	Douglas
डच	Dutch
डट	stop
डटे	stop
डन	Done
डनियॆल	Daniel
डब	Dub
डबल	Double
डबलयु	W
डबलयुटिए	WTA
डबलस	Doubles
डबलिन	Dublin
डबल्स	Doubles
डब्लिन	Dublin
डब्ल्यु	W
डब्ल्यू	W 
डब्ल्यूटीओ	WTO
डर	Fear
डरति	Fear
डरती	Fear
डरन	Fear
डरना	Fear
डरपॊक	Coward
डरपोक	Coward
डरबिशायर	Derbyshire
डरहम	Durham
डराइवर	Driver
डराइवरस	Driver
डराइविंग	Driving
डराईबर	Driver
डरॆं	Fear
डरॆंगॆ	Fear
डरें	Fear
डरेंगे	Fear
डरैगन	dragon
डरो	Fear
डर्बीशायर	Derbyshyre
डलवाएगि	Put on
डलवाएगी	Put on
डली	Smallbit
डांस	Dance
डाइ	die
डाइजॆसट	Digest
डाइजेस्ट	Digest
डाइरैकटएकस	DirectX
डाइरैक्टएक्स	DirectX
डाईट	Diet
डाउन	Down 
डाउनलॊड	Download
डाउनलॊडहरु	Downloader
डाउनलोड	Download
डाउनलोडहरू	Downloader
डाउलिंग	Dowling
डाक	Post
डाकटर	Doctor
डाकटरॆट	Doctorate
डाकटरॊं	Doctor
डाकयुमॆंटरिज	Documentaries
डाकसुचि	Postal index
डाकसूची	Postal index
डाकु	Thief
डाकू	Thief
डाक्टर	Doctor
डाक्टरों	Doctor
डाक्यूमेंटरीज	Documentary
डाट	scold
डाटकाम	dotcom
डाटा	Data
डाटाबॆस	Database
डाटाबेस	Database
डान	Don 
डामिनिक	Dominic
डायना	Diana
डायनासाॅर	Dinosaur
डायनासोर	Dinosaur
डायमंड	Diamond
डायरि	Dairy
डायरी	Dairy
डायरेक्टर	Director
डायल	dial
डारटमुंड	Dartmund
डारलिंग	Darling
डारविन	Darwin
डार्लिंग	Darling
डार्विन	Darwin
डाल	Put
डालकर	Put
डालती	Put
डालते	Put
डालना	Put
डालनॆ	Put
डालने	Put
डालपस	dollops
डालपिनॊं	Dolphin
डालमिया	Dalmiya
डालर	Dollar
डाला	Put
डालास	Dallas
डालिए	Put
डाली	Branch
डालुंग	put
डालूंगा	put
डालॆ	put
डालॆंगॆ	put
डालॆग	put
डाले	put
डालें	put
डालेंगे	put
डालेगा	put
डाल्फिनों	Dolphins
डाॅक्टर	Doctor
डाॅक्टरों	Doctors
डाॅट	Dot
डाॅन	Don 
डाॅलफिन	Dolphin 
डाॅलर	Dollar
डाॅल्फिन	Dolphin 
डिएनए	DNA
डिक	dick
डिकंस	Dickens
डिकन्स	Dickens
डिकशनरि	Dictionary
डिक्शनरी	Dictionary
डिग्री	Degree
डिजनि	Diesel
डिजल	Diesel
डिज़ाइन	design
डिज़ाइनर	designer
डिजाइन	Design
डिजाइनर	Design
डिजाईनर	Design
डिजिटल	Digital
डिज्नीलैंड	Disneyland
डिडि	DD
डिपटि	Deputy
डिपरंट	Different
डिप्टी	Deputy
डिप्लोमा	Diploma
डिफ्रंट	Different
डिबबॊं	box
डिब्बा	Box
डिब्बे	Box
डिमांड	Demand
डिमान्ड	demand
डिरॆकटरि	Directory
डिरेक्टरी	Directory
डिलिट	Delete
डिलीट	Delete
डिलीवरी	Delivery
डिवएकस	divx
डिवएक्स	divx
डिवाइड	Divide
डिविडि	Divide
डिविडिस	DVD
डिश	Dish
डिसकलॆमर	Disclaimer
डिसटराय	Destroy
डिसपॊजॆबल	Disposable
डिसॆंबर	December
डिसॆमबर	January
डिसेंबर	February
डिसेम्बर	March
डिस्कवरी	Discovery
डिस्क्लेमर	Disclaimer
डिस्ट्रॉय	Destroy
डिस्पोजेबल	Disposable
डिस्प्रोसियम	Disprosium
डिज़ाईनर	Designer
डीएनए	DNA
डीएस	DSicovery
डीजल	Diesel
डीज़ल	Diesel
डीडी	DD
डीप	Deep
डीपबर्नर	Deep burner
डीफेनबेकर	Deep burner
डीवीडी	DVD
डुंडनॆ	find
डुब	immerse
डुबतॆ	immerse
डुबनॆ	immerse
डुबि	immerse
डुबॆ	immerse
डूब	Immerse
डूबकी	Immerse
डूबते	Immerse
डूबने	Immerse
डूबा	Immerse
डूबी	Immerse
डूबे	Immerse
डॅनियेल	Daniel
डॅनिश	Danish
डॅाट	Dot
डॆंगु	Dengue
डॆंमारक	Denmark
डॆंमारकचॆ	Denmark
डॆंसिटि	Density
डॆकसटर	Dexter
डॆजरट	desert
डॆट	det
डॆटाबॆस	Database
डॆटिंग	Dating
डॆटॊनॆटरस	Detonators
डॆड	Half
डॆनमारक	Denmark
डॆनिश	Denise
डॆनिस	Denise
डॆमॊकरयासि	Democracy
डॆमॊकरॆट	Democrat
डॆमॊकरॆटिक	Democratic
डॆमॊकरॆटॊं	democrat
डॆमॊन	Demon
डॆर	tent
डॆरि	tent
डॆरॆक	derek
डॆविड	David
डॆसक	Desk
डॆसकटाप	Desktop
डॆसकटॊप	Desktop
डॆसमंड	Desmond
डेंगू	Dengue
डेंसिटी	density
डेक्स्टर	dexter
डेट	Date
डेटा	Date
डेटाबेस	database
डेटिंग	dating
डेटोनेटर्स	detonators
डेड	One and half
डेढ़	One and half
डेनमार्क	Denmark
डेनिएल	Daniel
डेनिश	denise
डेनिस	denise
डेन्मार्क	Denmark
डेन्मार्कचे	Denmark
डेमोक्रेट	democrat
डेमोक्रेटिक	Democratic
डेमोक्रेटों	democrat
डेमोक्र्यासि	democracy
डेमोन	demon
डेर	Tent
डेरा	Tent
डेरी	Tent
डेवलपमेंट	Development
डेविड	David
डेव्हिड	David
डेव्हिस	Davis
डेस्क	Desk
डेस्कटाप	Desktop
डेस्कटॉप	Desktop
डेस्कटॊप	Desktop
डेज़र्ट	desert
डेढ़	One and half
डैनियल	Daniel
डैनिश	Danish
डैमॊकरैट	democratic
डैमोक्रैट	democrat
डैवलपर	developer
डैसकटाप	Desktop
डैस्कटॉप	Desktop
डॉक्	Post
डॉक्टर	Doctor
डॉक्टरेट	Doctorate
डॉक्टरों	Doctor
डॉटकॉम	DotCom
डॉन	don
डॉमिनिक	Dominic
डॉमिनिकन	Domnican
डॉयरी	diary
डॉयल	dial
डॉर्टमुंड	Dortmund
डॉलर	Dollar
डॊमिनिक	Dominic
डॊमॆन	Domain
डोज	Dose
डोनेल	Donnell
डोम	Dome
डोमिनिक	Dominic
डोमिनिका	Dominic
डोमेन	domain
डोर	string
डोली	Bucket
ड्ब्ल्यूटीए	WTA
ड्यूटी	Duty
ड्राइवर	Driver
ड्राइवर्स	Driver
ड्राइविंग	Driving
ड्राईभर	Driver
ड्रामा	Drama
ड्रीम	dream
ड्रैगन	Dragon
ड्रॉ	Draw
ड्रॉफ़्ट	Draft
ढंग	manner
ढर्रे	Fear
ढले	cast
ढ़ाका	Dhaka
ढांचा	Frame
ढाई	Two and half
ढाक	cover
ढाका	cover
ढाल	armor
ढा़बा	Dhaba
ढील	loose
ढूँढता	Search
ढूँढना	Search
ढूंढ	Search
ढूंढने	Search
ढेर	Many
ढेरों	Many
ढोरे	Cattle
ढोल	Drum
तंग	Narrow
तंज़ानिया	Tanzania
तंजानिय	Tanzania
तंजानिया	Tanzania
तंजावर	Tanjaore
तंडरबरड	Thunderbird
तंत्र	machine
तंद्रा	Drowsiness
तंस़ानिया	Tanzania
तंसानिय	Tanzania
तंहाइयां	loneliness
तंहाई	loneliness
तंहाईयॊं	loneliness
तक	till
तकत	Pillow
तकदिर	fate
तकदीर	fate
तकनिक	Technique
तकनिकि	Technical
तकनिकॊं	Technique
तकनीक	Technique
तकनीकी	Technical
तकनीकों	Technique
तकनीक।	Technique
तकरीबन	Approximately
तकलिप	Problem
तकलीफ	Problem
तकलीफ़	Problem
तख्ता	Plank
तगड़ी	hardy
तगडि	hardy
तजाकिस्तान	Tazakistan
तट	Coast
तटसत	indifferent
तटस्थ	indifferent
तटीय	Coastal
तडपति	Restless
तडपाति	Restless
तड़पती	Restless
ततकाल	immediately
ततपर	Curious
ततपरत	Curious
ततवजञान	Philosophy
ततवजञानि	Philosophy
ततवॊं	elements
ततासतु	bless
तत्काल	Immediately
तत्कालीन	Currently
तत्त्व	element
तत्त्वज्ञान	Philosophy
तत्त्वज्ञानी	philosopher
तत्त्वे	elements
तत्पर	Curious
तत्परता	briskness
तत्व	essence
तत्वज्ञान	Philosophy
तत्वज्ञानी	philosopher
तत्वावधान	philosopher
तत्वों	elements
तथा	And
तथास्तु	bless
तथ्य	Proof
तथ्यों	Proof
तन	Body
तनविर	Tanvir
तनवीर	Tanvir
तनह	lonely
तनहा	loneliness
तनहाई	loneliness
तनाव	Tension
तनावकॊ	Tension
तनावको	Tension
तनावपुरन	Tension
तनावपूर्ण	Tension
तनुशरि	Tanusree
तनुश्री	Tanusree
तन्	mind
तन्त्र	machine
तन्स़ानिया	Tanzania
तन्हा	lonely
तन्हाइयाँ	loneliness
तन्हाई	loneliness
तन्हाईयों	loneliness
तप	Penance
तपति	Tapti
तपमान	temperature
तपस्या	meditate
तब	then
तबला	Tabla
तबियत	Health
तबीयत	Health
तब्बू	taboo
तभी	then
तमंन	Wish
तमन्ना	Wish
तमाम	All
तमाश	spectacle
तमाशा	spectacle
तमिल	Tamil
तमिलनाडु	Tamilnadu
तमिलनाडुयागु	Tamilnadu
तमिळ	Tamil
तय	decide
तयागराज	Tyagaraja
तयागि	Sacrifice
तयार	Ready
तयारि	Ready
तयारिम	Ready
तयारी	Ready
तयॊहार	Festival
तयौहार	Festival
तरंग	Wave
तरकश	quiver
तरक्की	Promotion
तरज	balance
तरण	young
तरफ	Side
तरफ़	Side
तरफा	Side
तरयंबकॆशवर	Triambakeswar
तरल	Liquid
तरस	sigh
तरसत	sigh
तरह	Like
तरहि	like
तरही	like
तराई	lowland
तराईम	lowland
तराईमा	lowland
तरिक	Method
तरिका	Method
तरिकॆ	Method
तरिकॊ	Method
तरिकॊं	Method
तरिकॊन	Triangle
तरिनिडाड	Trinidad
तरिपाटि	Tripathi
तरिवॆदि	Trivedi
तरिवॆनि	Triveni
तरिशंकु	Cone
तरिशुल	trident
तरिहि	like
तरीक़े	method
तरीका	method
तरीके	method
तरीकों	method
तरीखो	method
तरीही	method
तरीक़ों	method
तरुण	young
तरुन	young
तर्क	logic
तरफ़	Side
तल	Surface
तलवार	Sword
तलवारॆं	Sword
तलवारें	Sword
तलाक	Divorce
तलाश	Search
तलाशत	Search
तलाशता	Search
तलाशने	Search
तलाशि	Search
तलाशी	Search
तसकरि	Steal
तसलिम	Taslim
तसलीम	Taslim
तसविर	Photograph
तसविरॆं	Photograph
तसविरॊं	Photograph
तसुनामि	Tsunami
तस्कर	smuggle
तस्करी	smuggle
तस्करों	smuggle
तस्बिर	Photograph
तस्वीर	Photograph
तस्वीरें	Photograph
तस्वीरों	Photograph
तह	strata
तहत	according
तहलका	Tahelka
तहसील	Tahsil
तांडव	Dance
तांतरिक	sorcerer
तांत्रिक	sorcerer
तांत्रीक	sorcerer
ताइलैंड	Thailand
ताइवान	Taiwan
ताइवानि	Taiwan
ताइवानी	Taiwan
ताई	Sister
ताईं	Sister
ताईपॆई	Taipei
ताईपेई	Taipei
ताईलैंड	Thailand
ताईवान	Taiwan
ताऊ	uncle
ताकत	Power
ताकतवर	Powerful
ताकतॆ	Power
ताकतॆं	Power
ताकते	Power
ताकतें	Power
ताकि	So that
ताज	taj 
महल	mahal
ताजगी	Freshness
ताजमहल	Tajmahal
ताज़ा	Fresh
ताज़ी	Fresh
ताजा	Fresh
ताजि	Fresh
ताजिकिसतान	Tajakistan
ताजिकिस्तान	Tajakistan
ताजॆ	Fresh
ताजे	Fresh
तातकालिक	Temporary
तात्कालिक	Temporary
तात्पर्य	Meaning
तादाद	Quantity
तान	Tune
तानसॆन	Tansen
तानसेन	Tansen
ताना	Warp,Taunt
तानाजि	Tanaji
तानाजी	Tanaji
तानाशाह	Tanashah
तानाशाहॊं	Tanashah
तानाशाहों	Tanashah
तानॆ	Thane
ताने	Thane
तापमान	Temperature
तापि	heat
तापी	heat
ताबुत	coffin
तामर	Lotus
तामिळनाडु	Tamilnadu
तामिळनाडुमदिल	Tamilnadu
तामीळनाडू	Tamilnadu
तामीळनाडूमधील	Tamilnadu
ताम्र	gold
तायलंड	Thailand
तार	Telegram
तारा	Star
तारापुर	Tarapur
तारारमपम	Tararumpum
ताराशंकर	Tarashankar
तारिक	Date
तारिकॆ	Date
तारिप	Praise
तारीख	Date
तारीखे	Date
तारीफ	Praise
तारीफ़	Praise
तारुण्य	youth
तारुनय	youth
तारे	Star
तारॊ	Star
तारॊं	Star
तारो	Star
तारों	Star
ताल	clap
तालमॆल	Combination
तालमेल	Combination
ताला	Lock
तालाब	Pond
तालाबानि	Lockout
तालाबानी	Lockout
तालि	Clap
तालिका	List
तालिबान	Taliban
तालिबानि	Taliban
तालिबानियॊ	Taliban
तालिबानियॊं	Taliban
तालिबानियो	Taliban
तालिबानियों	Taliban
तालिबानी	Taliban
तालिबानॊं	Taliban
तालिबानों	Taliban
तालिम	Education
ताली	clap
तालीबान	Taliban
तालॆबान	Taliban
तालेबान	Taliban
ताहिर	Taher
ताज़ा	Fresh
तितर	Scatter
तितलि	Butterfly
तितलियाँ	Butterfly
तितलियां	Butterfly
तितलियों	Butterfly
तितली	Butterfly
तिथि	Date
तिपसॆ	Tipsay
तिबॆट	Tibet
तिबेट	Tibet
तिब्बत	Tibet
तिब्बती	Tibet
तिमपु	Thimpu
तिमॊर	Timor
तिमोर	Timor
तियॆटर	Theatre
तियॊडॊर	Theodre
तिरंग	Tricolour
तिरंगा	Tricolour
तिरंगॆ	Tricolour
तिरंगे	Tricolour
तिरचि	Slanting
तिरछी	Slanting
तिरत	quick
तिरतयातर	Pilgrimage
तिरतयातरि	Pilgrimage
तिरतयातरियॊं	pilgrims
तिरपन	Fifty three
तिरसकारित	Rejected
तिरसट	Sixty three
तिरसठ	Sixty three
तिरस्कारित	Rejected
तिरानवॆ	Ninety three
तिरानवे	Ninety three
तिरासि	eighty three
तिरासी	eighty three
तिरुअनंतपुरम	Tiruvananthapuram
तिरुपति	Tirupati
तिरुवरुर	Tiruvarur
तिरूवरुर	Tiruvarur
तिर्यक	across
तिल	Sesamum
तिलक	Tilak
तिलकरतनॆ	Tilakratne
तिलकरत्ने	Tilakratne
तिलहन	Oil seeds
तिलॊततम	Tilottama
तिलोत्तमा	Tilottama
तिवारि	Tiwari
तिवारी	Tiwari
तिवारी।	Tiwari
तिसरा	third
तिसरि	third
तिसरॆ	third
तिसरे	third
तिहततर	Seventy three
तिहत्तर	Seventy three
तिहाई	One third
तिहाड	One third
तिहार	Threefold 
तीखी	Sharp
तीखे	Sharp
तीन	Three
तीनों	Three
तीया	woman
तीर	Arrow
तीरंदाज	sure
तीर्थ	Sacred
तीर्थक्षेत्रे	Sacred place
तीर्थयात्रा	Piligrimage
तीर्थयात्रियों	Piligrims
तीर्थयात्री	Piligrim
तीली	Spoke
तीव्र	Severe
तीव्रता	Severe
तीस	Thirty
तीसरा	Third
तीसरी	Third
तीसरे	Third
तु	you
तुंग	high
तुक	Rhyme
तुकक	Piece
तुकडॆ	Piece
तुकडे	Piece
तुकाराम	Tukaram
तुज	You
तुजकॊ	You
तुजसॆ	You
तुजॆ	You
तुझ	You
तुझको	You
तुझसे	You
तुझे	You
तुझ्या	You
तुन्गनाथ	Tunganath
तुपान	cyclone
तुपानगरसत	cyclone
तुम	You
तुमकॊ	You
तुमको	You
तुमनॆ	You
तुमने	You
तुमसॆ	You
तुमसे	You
तुमहार	Yours
तुमहारि	Yours
तुमहारॆ	Yours
तुमहॆ	you
तुमहॆं	you
तुम्	you
तुम्हारा	Yours
तुम्हारी	Yours
तुम्हारे	Yours
तुम्हे	You
तुम्हेँ	You
तुम्हें	You
तुरंत	Quick, soon
तुरकमॆन	Turk
तुरकमॆनिसतान	Turkmenistan
तुरकि	Turkey
तुरकियॆ	Turkey
तुरकियॊं	Turkey
तुरतुरिय	horn
तुरतुरिया	horn
तुरी	trumpet
तुर्कमेन	Turk
तुर्कमेनिस्तान	Turkmenistan
तुर्किये	Turkey
तुर्कियों	Turkey
तुर्की	Turkey
तुलन	Compare
तुलना	Compare
तुलनातमक	Comparable
तुलनात्मक	Comparable
तुलसि	Tulasi
तुलसिदास	Tulasidas
तुलसी	Tulsi
तुलसीदास	Tulasidas
तुला	Balance
तुलाचन	Balance
तुलिक	spotted
तुलियम	Compare
तुलॊं	Compare
तुलों	Compare
तुवर	pigeon pea
तुशार	Tushaar, frost
तुषार	Frost
तुसाड	Tussade
तू	You
तूँ	You
तूने	You
तूफ़ान	Cyclone
तूफान	Cyclone
तूफानग्रस्त	Cyclone
तूफानी	Cyclonic
तूफानों	Cyclones
तूर	kind of
तूलिका	Brush
तूळ	Cotton
तूफ़ान	Cyclone
तृणमुल	Third
तृतियः	Third
तृतीय	Third
तृतीयः	Third
तृनमुल	Trunamul
तॄश	Trisha
तॄषा	Trisha
तॆ	they
तॆंकसगिविंग	Thanks giving
तॆंडुलकर	Tendulkar
तॆंदुलकर	Tendulkar
तॆईस	Twenty three
तॆईसवां	Twenty third
तॆज	Glory
तॆजस	Glory
तॆजि	Sharpness
तॆजॆंदर	Tejender
तॆजॆशवर	Tejeshwar
तॆनसिंग	Tensing
तॆरह	Thirteenth
तॆरहवां	Thirteenth
तॆरि	Yours
तॆरॆ	Yours
तॆलुगु	Telugu
तॆवर	Angry look
तॆहरान	Tehran
ते	they
तेंडुलकर	Tendulkar
तेंदुलकर	Tendulkar
तेईस	Twenty Three
तेईसवां	Twenty Third
तेज	Glory
तेजस	glory, shine
तेज़	Fast, tough, heavy
तेज़ी	Fast, tough, heavy
तेजी	Sharpness
तेजेन्द्र	Tejendra
तेनसिंग	Tensing
तेपेइ	Teipie
तेरह	Thirteen
तेरहवां	Thirteenth
तेरा	Yours
तेरावा	Thirteenth
तेरावे	Thirteenth
तेरी	Your
तेरे	Your
तेरेसा	Teresa
तेरो	your
तेल	Oil
तेली	Oil man
तेलुगु	Telugu
तेलुगू	Telugu
तेवर	Angry look
तेहरान	Tehran
तेज़	Fast
तैंतालिस	Forty three, 43
तैंतिस	Thirty three, 33
तैनात	Security
तैनाती	Secure
तैयार	Ready
तैयारि	Preparation
तैयारियाँ	Preparations
तैयारियों	Ready
तैयारी	Ready
तैरत	Swimmer
तैरने	Swim
तैराक	Swim
तैवान	Taiwan
तॊड	Break
तॊडपॊड	Breakage, damage
तॊडि	Broke
तॊमस	Thomas
तॊरिनॊ	Torino
तॊलिया	Towel
तॊहर	Your
तो	Else
तोडफोड	Breakage, damage
तोड़	Break
तोड़ना	Breaking
तोड़ने	Break
तोड़ा	Break
तोता	Parrot
तोबा	Excuse
तोहफ़ा	Gift
तोहफा	Gift
तोहरा	Your
तोड़	Break
तोड़ने	Break
तोड़ा	Break
तौर	Method, approach
त्याग	Sacrifice
त्योहार	Festival
त्योहारों	Festivals
त्रिकोण	Triangle
त्रिकोणीय	Triangular
त्रिपाठी	Tripathi
त्रिपुरा	Tripura
त्रिवेणी	Triveni
त्रिवेदी	Trivedi
त्रिशूल	Trishul, Trident
त्र्यंबकेश्वर	Trayambakeshwar
त्वचा	Body, Skin
त्सूनामी	Tsunami
तख़्त	Strict
तड़पाती	Made to suffer
थक	Tire
थकान	Tireness
थके	Tired
थन्डरबर्ड	Thunderbird
थप्पड़	Slap
थम	Stand by, stop
थमा	Prefix, prior
थलसेना	Army, land forces
थाइलैंड	Thailand
थाइवान	Taiwan
थाई	Thai
थाईलैंड	thailand
थाना	Jail
थाने	Jail
थायलंड	Thailand
थार	Thar
थाली	Plate
थियेटर	Theater
थीम	Theme
थेंक्सगिविंग	Thanksgiving
थैंक्यू	Thank you
थैंक्स	Thanks
थैंक्सगिविंग	Thanksgiving
थॉमसन	Thomson
थॉम्पसन	Thompson
थो	Then
थोड़ा	little
थोड़ी	little
थोड़े	little
थोमस	Thomas
थोड़ा	little
थोड़ी	little
थोड़े	little
दंग	Surprised
दंगा	Rumor
दंगे	Rumor
दंगों	Rumor
दंड	Punish
दंत	Tooth
दंपति	Married Couple
दंश	Bite
दकशिन	South
दक्षिण	south
दक्षिणी	South
दखल	Interrupt
दत्त	Pay
दत्ता	Dutta
दत्तात्रय	Duttatray
दनंजय	Dhananjay
दफनाने	cremate
दफनाया	Cremate
दफ्तर	Office
दबा	Press
दबाव	Pressure
दबे	Press
दम	Strength
दमदार	Strong
दमन	Suppression
दया	compassion
दयानंद	Dayanand
दयाल	Dayal
दर	Fare
दरअसल	Actually
दरकार	respectful
दरजनॊं	Dozen
दरपन	Mirror
दरबार	Court
दरमियाँ	During
दरमियां	During
दरवाज़ा	Door
दरवाजा	Door
दरवाजे	Doors
दरार	Gap
दर्ज	Record
दर्जन	Recording
दर्जनों	Record
दर्जा	Class
दर्द	Pain
दर्पण	Mirror
दर्शक	Audience
दर्शकों	Audience
दर्शन	View
दल	Gang
दलदल	swamp
दलाई	Dalai
दलाईलामा	Dalai lama
दलाल	Broker
दलित	Underprivileged  
दलितों	Underprivileged  
दलील	Argument, plea
दलों	Gang, troop
दवलागिरि	Davalagiri
दवा	Medicine
दवाई	Medicine
दवाएं	Medicine
दवाओं	Medicine
दवाखाना	Pharmacy
दशक	decade
दशकों	decade
दशरत	Dashrath
दशरथ	Dashrath
दशहरा	Dussera
दशा	Condition
दस	Ten 
दसवां	Tenth
दसॊं	Tens 
दस्तक	Artisan
दस्तख़त	Signature
दस्तावेज	Document
दहशत	Violence
दही	Curd
दहेज	Dowry
दहेज़	Dowry
दाँव	gamble
दांडेकर	Daandekar
दांत	Teeth
दांव	gamble
दाई	grand mother
दाउद	Daawood
दाऊद	Daawood
दाखिल	Join
दाखिला	Join
दाग	Blot
दागा	Thread
दागे	bazooka
दाडि	Beard
दाद	Ringworm
दादर	Dadar
दादरा	Dadra
दादा	Grandfather
दादाजी	Grandfather
दादी	Grandmother
दान	Donate
दाना	Grain
दाने	Grain
दाम	Fare
दामाद	Son in law
दामॊदर	Damodar
दायरा	Frame
दायरे	Near by
दायित्व	Role
दारफुर	Darfur
दारावाहिक	Serial
दारु	Liquor
दार्शनिक	Viewable
दाल	Dal
दावत	Party
दावा	Claim
दावे	Claim
दावेदार	Claim
दास	Servant
दास्तान	Story
दिए	Gave
दिकशित	dixit
दिक्कत	Discomfort
दिख	see
दिखता	see
दिखती	see
दिखते	see
दिखने	see
दिखा	Show
दिखाई	Show
दिखाए	Show
दिखाकर	Show
दिखाता	Show
दिखाते	Show
दिखाना	Show
दिखाने	Show
दिखाया	Show
दिखी	Seen
दिखे	Seen
दिखेंगे	Seen
दिगविजय	victorious
दिग्गज	Expert
दिग्विजय	Digvijay
दिदि	Sister
दिन	Day
दिनकर	Dinakar
दिनचर्या	Days work
दिनभर	Whole day
दिनांक	Date
दिनार	Dinar
दिनॆश	dinesh
दिनॆशपाटक	Dinesh pathak
दिनेश	Dinesh
दिनॊ	Days  
दिनों	Days  
दिपक	lamp
दिपकबापु	Dipak babu
दिपति	Dipti
दिपावलि	Dipawali
दिमाग	Brain, mind
दिया	Give
दिये	Give
दिरेक्टेर्स	Directors
दिल	Heart
दिलचस्प	Interesting
दिलचस्पी	Interest
दिलबर	Sweetheart
दिललगि	Heart break
दिलिप	Dilip
दिलों	Hearts
दिल्ली	Delhi
दिवस	Day
दिवसीय	Day
दिवान	Seat rest
दिवानगी	Madness
दिवाना	Mad
दिवार	Wall
दिवाली	Diwali
दिव्य	Devine, supernatural
दिव्या	Divya
दिशा	Direction, Way
दिसंबर	December
दिसपुर	Dispur
दिसम्बर	December
दीक्षा	Vow
दीक्षित	Dixit
दीजिए	Give
दीदी	Sister
दीप	Lamp
दीपक	lamp
दीपकबापू	Deepakbabu
दीपकभारतदीप	Deepak barat deep
दीपा	Deepa
दीपावली	Diwali
दीया	Lamp
दीर्घ	Long
दीवाना	Mad
दीवानी	Mad
दीवाने	Mad
दीवार	Wall
दीवारों	Wall
दीवाली	diwali
दुःख	Sad
दुःखी	Sad
दुआ	Blessing
दुकान	Shop
दुकानदार	Shopkeeper
दुकानें	Shops
दुकानों	Shops
दुख	Sad
दुखद	Sad
दुखी	Sad
दुनिया	World
दुनियाभर	World
दुपट्टा	Scarf
दुबई	Dubai
दुबारा	Again
दुबॆ	Dubey
दुराचार	Bad manners
दुरुपयोग	Misuse
दुरुस्त	Fine
दुर्ग	Durg
दुर्गन्धित	Polluted
दुर्गा	Durga
दुर्गाप्रसाद	DurgaPrasad
दुर्घटना	Accident
दुर्घटनाग्रस्त	Accident prone
दुर्दशा	Bad condition
दुर्भाग्य	Bad luck
दुर्भाग्यपूर्ण	Unlucky
दुर्लभ	Weak
दुर्व्यवहार	abuse 
दुलहन	Bride
दुलहनिया	Bride
दुल्हन	Bride
दुविधा	Problem
दुशपरचार	Rumor
दुशयंत	Dushyant
दुश्मन	Enemy
दुष्कर्म	Bad deed
दुष्प्रचार	Rumor
दुष्यंत	Dushyant
दुष्यन्त	Dushyant
दूंगा	Give
दूत	Messenger
दूतावास	Chancellery
दूध	Milk
दूर	Far
दूरदर्शन	Doordarshan
दूरबीन	Telescope
दूरसंचार	Door sanchar
दूरियां	distances
दूरी	Distance
दूसरा	Second
दूसरे	Other
दूसरों	Others
दृढ़ता	Determination
दृपल	Drupal
दृश्य	Picture
दृश्यों	Picture
दृष्टि	Sight
दृष्टिकोण	Viewpoint
दृढ़	Firm
दॆबाशिश	Debashish
दॆबु	Debu
दॆवकि	Devaki
दॆवगन	Devagan
दॆवदास	Devadas
दॆवराज	Devaraj
दॆवलॊक	Heaven
दॆवि	goddess
दॆविलाल	Devilal
दॆवॆंदरनात	Devendernath
दॆवॆश	Devesh
दॆश	Country
दॆशपांडॆ	Deshpande
दॆशवयापि	Countrywide
दॆसाई	Desai
दॆसि	Ingenious
दॆहरादुन	dehradun
देंगी	Give
देंगे	Give
देऊ	Dewoo
देकर	Giving
देख	see
देखकर	see
देखता	see
देखती	see
देखते	see
देखना	see
देखने	see
देखभाल	Taking care
देखरेख	Taking care
देखा	Seen
देखिए	see
देखी	Seen
देखे	See 
देखें	see
देखेंगे	See 
देखो	See 
देगा	Give
देगी	Give
देता	Give
देती	Give
देते	Give
देन	Give
देना	Give
देनी	Give
देने	Give
देबाशीष	Debashish
देबू	Debu
देर	Delay
देरी	Delay
देव	Dev
देवकी	devaki
देवगन	Devgan
देवगिरि	Devagiri
देवता	God
देवताओं	God
देवदत्त	Devadutt
देवदास	devadas
देवनागरी	Devanagari
देवराज	devaraj
देवलोक	Heaven
देवी	Goddess
देवेश	Devesh
देश	Country
देशपांडे	deshpande
देशभक्ति	Patriotic
देशभर	Country wide
देशमुख	Deshmukh
देशव्यापी	Country wide
देशी	Desi, citizen
देशों	Country
देसी	Citizen
देह	Body
देहरादून	Dehradun
दैनिक	Dainik
दॊगुनि	Twice
दॊनॊ	Both
दॊनॊं	Both
दॊपहर	Afternoon
दॊमुंहि	Double faced
दॊशहिन	Unconvicted
दॊशारॊपन	Accuse
दॊहॆ	Poem
दो	Two
दोगुना	Twice
दोगुनी	Twice
दोनो	Both
दोनों	Both
दोपहर	Afternoon
दोबारा	Again
दोमुंही	Double faced
दोष	Blame
दोषारोपण	Accuse
दोषी	Convict
दोस्त	Friend
दोस्ताना	Friendship
दोस्ती	Friendship
दोस्तों	Friends 
दोहरा	Repeat
दोहराया	Repeat
दोहरी	Repeat
दोहरे	Repeat
दोहे	Poem
दौड	Run
दौड़	Run
दौर	Version
दौरा	Repeat
दौरान	Repeat
दौरे	Repeat
दौलताबाद	Doulatabad
दौड़	Run
दौड़ती	Running
द्रविड	dravid
द्रविड़	Dravid
द्रविड़	Dravid
द्रव्य	Liquid
द्रोणाचार्य	Dronacharya
द्वार	Door
द्वारकानाथ	Dwarakanath
द्वारा	Due to
द्वितीय	Second
द्विपक्षीय	Bilateral
द्विभाषा	Bilingual
द्विवेदी	Dvivedi
द्वीप	Island
द्वीपसमूह	Cluster of islands
धंधा	Business
हैरान 	Tense 
हॉलीवुड 	hollywood 
होंठ	 Lips 
होटल 	Hotel 
होटलों 	Hotels 
हौसला	 Faith 
हौसले 	Faith 
